AAAAATAATTC -> AAAATAATTCA
AAAACTGGGGC -> AAACTGGGGCG
AAAAGCACGAT -> AAAGCACGATT
AAAAGGCAGTA -> AAAGGCAGTAC
AAAATAATTCA -> AAATAATTCAT
AAAATTTCCTA -> AAATTTCCTAC
AAACAATTACC -> AACAATTACCA
AAACACCTCGT -> AACACCTCGTT
AAACATACTTT -> AACATACTTTG
AAACCACGCCC -> AACCACGCCCA
AAACCCCGAGG -> AACCCCGAGGT
AAACTGGGGCG -> AACTGGGGCGT
AAACTTTCGCC -> AACTTTCGCCG
AAAGACAATGG -> AAGACAATGGA
AAAGACGAGCT -> AAGACGAGCTC
AAAGACGTCGG -> AAGACGTCGGT
AAAGATCTGGT -> AAGATCTGGTT
AAAGCACGATT -> AAGCACGATTC
AAAGCCCTTTG -> AAGCCCTTTGA
AAAGGCAGTAC -> AAGGCAGTACT
AAAGTTTGCCC -> AAGTTTGCCCG
AAATAAGAGCG -> AATAAGAGCGT
AAATAATTCAT -> AATAATTCATC
AAATACAATTA -> AATACAATTAA
AAATAGTATCG -> AATAGTATCGG
AAATTAGCGAG -> AATTAGCGAGG
AAATTCTTCGG -> AATTCTTCGGG
AAATTGATATT -> AATTGATATTT
AAATTTCCTAC -> AATTTCCTACT
AACAAAAGGCA -> ACAAAAGGCAG
AACAATTACCA -> ACAATTACCAA
AACACAAAAAT -> ACACAAAAATA
AACACCTCGTT -> ACACCTCGTTT
AACAGGCCGTA -> ACAGGCCGTAT
AACATACTTTG -> ACATACTTTGT
AACCAATAATG -> ACCAATAATGT
AACCAATGTGA -> ACCAATGTGAC
AACCACGCCCA -> ACCACGCCCAC
AACCCCGAGGT -> ACCCCGAGGTA
AACCGAGATGA -> ACCGAGATGAT
AACGCGTTCCA -> ACGCGTTCCAA
AACGCTAGACG -> ACGCTAGACGA
AACGCTAGGCA -> ACGCTAGGCAC
AACTAAGGTTC -> ACTAAGGTTCC
AACTACATAAG -> ACTACATAAGC
AACTATAGGGA -> ACTATAGGGAG
AACTCACCTTA -> ACTCACCTTAC
AACTCCTAGGA -> ACTCCTAGGAG
AACTGGGGCGT -> ACTGGGGCGTT
AACTGTCACAC -> ACTGTCACACT
AACTTGGGGCC -> ACTTGGGGCCA
AACTTTCGCCG -> ACTTTCGCCGT
AAGACAATGGA -> AGACAATGGAC
AAGACGAGCTC -> AGACGAGCTCT
AAGACGTCGGT -> AGACGTCGGTA
AAGAGACTTCA -> AGAGACTTCAA
AAGAGCGTTAC -> AGAGCGTTACA
AAGAGGAATGG -> AGAGGAATGGG
AAGATCTGGTT -> AGATCTGGTTA
AAGATGAGGCT -> AGATGAGGCTT
AAGATGCTGAA -> AGATGCTGAAA
AAGATTGAACA -> AGATTGAACAG
AAGATTGCAAA -> AGATTGCAAAC
AAGCAAAGTTT -> AGCAAAGTTTG
AAGCACGATTC -> AGCACGATTCC
AAGCACTTAGC -> AGCACTTAGCC
AAGCCCTTTGA -> AGCCCTTTGAT
AAGCCTGCACG -> AGCCTGCACGG
AAGCGGCATCT -> AGCGGCATCTG
AAGCGTAGGTT -> AGCGTAGGTTT
AAGCGTGATGA -> AGCGTGATGAG
AAGCGTTCTGA -> AGCGTTCTGAT
AAGCTACATGA -> AGCTACATGAG
AAGCTCCCATA -> AGCTCCCATAT
AAGGATCAAAC -> AGGATCAAACA
AAGGCAGTACT -> AGGCAGTACTG
AAGGCTGCACC -> AGGCTGCACCG
AAGGTATTTTT -> AGGTATTTTTC
AAGGTTCCGTA -> AGGTTCCGTAG
AAGTGACCGTA -> AGTGACCGTAC
AAGTGCTAAGC -> AGTGCTAAGCA
AAGTTGAATAC -> AGTTGAATACA
AAGTTTGCCCG -> AGTTTGCCCGG
AATAAGAGCGT -> ATAAGAGCGTT
AATAATGTTTC -> ATAATGTTTCT
AATAATTCATC -> ATAATTCATCC
AATACAACGCT -> ATACAACGCTA
AATACAATTAA -> ATACAATTAAT
AATAGGAGTTT -> ATAGGAGTTTA
AATAGGGGAGG -> ATAGGGGAGGC
AATAGTATCGG -> ATAGTATCGGA
AATATACTATA -> ATATACTATAA
AATCAACCAAT -> ATCAACCAATG
AATCGATTGGG -> ATCGATTGGGA
AATCGGGACAT -> ATCGGGACATC
AATCTCGCGCC -> ATCTCGCGCCA
AATCTGCGTGT -> ATCTGCGTGTT
AATGCAGAGAG -> ATGCAGAGAGA
AATGCGCCTAT -> ATGCGCCTATG
AATGCGCGATC -> ATGCGCGATCG
AATGGACCCTG -> ATGGACCCTGC
AATGGCAAAGA -> ATGGCAAAGAC
AATGGCCCTCA -> ATGGCCCTCAA
AATGGGTCTAC -> ATGGGTCTACA
AATGGTATGGA -> ATGGTATGGAC
AATGTGACAGT -> ATGTGACAGTT
AATGTTTCTAT -> ATGTTTCTATC
AATTAATTTGG -> ATTAATTTGGG
AATTACCAAGC -> ATTACCAAGCG
AATTAGCGAGG -> ATTAGCGAGGA
AATTCATCCAC -> ATTCATCCACG
AATTCTTCGGG -> ATTCTTCGGGA
AATTGATATTT -> ATTGATATTTA
AATTTCCTACT -> ATTTCCTACTA
AATTTGGGCGG -> ATTTGGGCGGT
AATTTTAGCAG -> ATTTTAGCAGC
ACAAAAATAAT -> CAAAAATAATT
ACAAAAGGCAG -> CAAAAGGCAGT
ACAAACCACGC -> CAAACCACGCC
ACAAATAGTAT -> CAAATAGTATC
ACAACGCTAGG -> CAACGCTAGGC
ACAAGTTGAAT -> CAAGTTGAATA
ACAATCAACCA -> CAATCAACCAA
ACAATCTGCGT -> CAATCTGCGTG
ACAATGGACCC -> CAATGGACCCT
ACAATTAATTT -> CAATTAATTTG
ACAATTACCAA -> CAATTACCAAG
ACACAAAAATA -> CACAAAAATAA
ACACAAGTTGA -> CACAAGTTGAA
ACACCAGCGTT -> CACCAGCGTTA
ACACCTCGTTT -> CACCTCGTTTG
ACACGCAAGGA -> CACGCAAGGAT
ACACTTGAGTC -> CACTTGAGTCC
ACAGGCCGTAT -> CAGGCCGTATC
ACAGTTCACAC -> CAGTTCACACA
ACATAAGCCTG -> CATAAGCCTGC
ACATACTTTGT -> CATACTTTGTG
ACATAGCGACG -> CATAGCGACGA
ACATAGGCGAT -> CATAGGCGATC
ACATCCCTTAT -> CATCCCTTATT
ACATCGTTCCG -> CATCGTTCCGA
ACATGAGGGCC -> CATGAGGGCCA
ACCAAGCGTAG -> CCAAGCGTAGG
ACCAATAATGT -> CCAATAATGTT
ACCAATGTGAC -> CCAATGTGACA
ACCACGCCCAC -> CCACGCCCACG
ACCAGAGTGTT -> CCAGAGTGTTG
ACCAGCGTTAT -> CCAGCGTTATT
ACCATTGCACC -> CCATTGCACCC
ACCCAGAAGAG -> CCCAGAAGAGG
ACCCATTGAGA -> CCCATTGAGAG
ACCCCGAGGTA -> CCCCGAGGTAG
ACCCCTCCCAC -> CCCCTCCCACT
ACCCGCCGCTT -> CCCGCCGCTTC
ACCCTGCTCCT -> CCCTGCTCCTC
ACCGAGATGAT -> CCGAGATGATA
ACCGATATCAG -> CCGATATCAGG
ACCGGATATGT -> CCGGATATGTG
ACCGTACGGTC -> CCGTACGGTCA
ACCGTCTGGGG -> CCGTCTGGGGG
ACCGTGTGGTT -> CCGTGTGGTTT
ACCTCGGGTAC -> CCTCGGGTACG
ACCTCGTTTGT -> CCTCGTTTGTC
ACCTGTCATAG -> CCTGTCATAGT
ACCTTACCGTG -> CCTTACCGTGT
ACGAATTTTAG -> CGAATTTTAGC
ACGAGCTCTGT -> CGAGCTCTGTT
ACGAGGGATAT -> CGAGGGATATC
ACGAGTTGATA -> CGAGTTGATAT
ACGATCCTGGA -> CGATCCTGGAG
ACGATTCCGAA -> CGATTCCGAAA
ACGCAAAGCCC -> CGCAAAGCCCT
ACGCAAGGATC -> CGCAAGGATCA
ACGCCCACGCA -> CGCCCACGCAA
ACGCCGGTTAA -> CGCCGGTTAAG
ACGCGACGAGG -> CGCGACGAGGG
ACGCGTTCCAA -> CGCGTTCCAAC
ACGCTACTAGC -> CGCTACTAGCC
ACGCTAGACGA -> CGCTAGACGAA
ACGCTAGGCAC -> CGCTAGGCACC
ACGCTATTTAC -> CGCTATTTACG
ACGGAAGATGA -> CGGAAGATGAG
ACGGCGTCGGA -> CGGCGTCGGAG
ACGGCTAGCTT -> CGGCTAGCTTC
ACGGGATCATC -> CGGGATCATCG
ACGGGCACTTG -> CGGGCACTTGC
ACGGGGACGTC -> CGGGGACGTCT
ACGGTAGAGTG -> CGGTAGAGTGC
ACGGTCAGTTG -> CGGTCAGTTGG
ACGGTCCTTCA -> CGGTCCTTCAC
ACGGTTCAATG -> CGGTTCAATGG
ACGTAACTACA -> CGTAACTACAT
ACGTATCAAGA -> CGTATCAAGAG
ACGTCGGTACG -> CGTCGGTACGT
ACGTCTGATCC -> CGTCTGATCCT
ACGTGTCAGGG -> CGTGTCAGGGC
ACGTTCAACCA -> CGTTCAACCAA
ACGTTGTCTGT -> CGTTGTCTGTC
ACTAAGGTTCC -> CTAAGGTTCCG
ACTACATAAGC -> CTACATAAGCC
ACTACTATTGG -> CTACTATTGGA
ACTAGCCGAAG -> CTAGCCGAAGT
ACTATAACTCA -> CTATAACTCAC
ACTATAGCTTT -> CTATAGCTTTA
ACTATAGGGAG -> CTATAGGGAGA
ACTATTGGATA -> CTATTGGATAT
ACTCAAGCGTT -> CTCAAGCGTTC
ACTCACCTTAC -> CTCACCTTACC
ACTCATGGTTA -> CTCATGGTTAA
ACTCCTAGGAG -> CTCCTAGGAGT
ACTCGATTTGT -> CTCGATTTGTT
ACTCTTAATGC -> CTCTTAATGCG
ACTGAAACTTT -> CTGAAACTTTC
ACTGAAATACA -> CTGAAATACAA
ACTGGGAGAAT -> CTGGGAGAATA
ACTGGGGCGTT -> CTGGGGCGTTG
ACTGTCACACT -> CTGTCACACTT
ACTTAGCCAAA -> CTTAGCCAAAG
ACTTCAATGCA -> CTTCAATGCAG
ACTTGAGTCCC -> CTTGAGTCCCA
ACTTGCCGTTG -> CTTGCCGTTGG
ACTTGCGAAAT -> CTTGCGAAATT
ACTTGGGGCCA -> CTTGGGGCCAT
ACTTTCGCCGT -> CTTTCGCCGTG
ACTTTGTGATA -> CTTTGTGATAC
ACTTTTTACCA -> CTTTTTACCAT
AGAAGAGGAAT -> GAAGAGGAATG
AGAAGATGCTG -> GAAGATGCTGA
AGAAGTGCTAA -> GAAGTGCTAAG
AGAATAGGGGA -> GAATAGGGGAG
AGAATCTCGCG -> GAATCTCGCGC
AGACAAATAGT -> GACAAATAGTA
AGACAATGGAC -> GACAATGGACC
AGACGAATTTT -> GACGAATTTTA
AGACGAGCTCT -> GACGAGCTCTG
AGACGGAAGAT -> GACGGAAGATG
AGACGGTAGAG -> GACGGTAGAGT
AGACGTCGGTA -> GACGTCGGTAC
AGACGTTCAAC -> GACGTTCAACC
AGACTTCAATG -> GACTTCAATGC
AGAGAAGTGCT -> GAGAAGTGCTA
AGAGAATCTCG -> GAGAATCTCGC
AGAGACTTCAA -> GAGACTTCAAT
AGAGAGAATCT -> GAGAGAATCTC
AGAGCGTTACA -> GAGCGTTACAA
AGAGGAATGGG -> GAGGAATGGGT
AGAGGGGACCG -> GAGGGGACCGA
AGAGTGCCTGG -> GAGTGCCTGGC
AGAGTGTTGAT -> GAGTGTTGATT
AGATCTGGTTA -> GATCTGGTTAC
AGATGAGGCTT -> GATGAGGCTTC
AGATGATAGGT -> GATGATAGGTG
AGATGCTGAAA -> GATGCTGAAAC
AGATGGTAGGC -> GATGGTAGGCC
AGATTGAACAG -> GATTGAACAGG
AGATTGCAAAC -> GATTGCAAACA
AGATTGCTTAA -> GATTGCTTAAA
AGATTGTTAAC -> GATTGTTAACA
AGCAAAATTTC -> GCAAAATTTCC
AGCAAAGTTTG -> GCAAAGTTTGC
AGCACGATTCC -> GCACGATTCCG
AGCACTTAGCC -> GCACTTAGCCA
AGCAGCCCTTT -> GCAGCCCTTTC
AGCCAAAGACG -> GCCAAAGACGT
AGCCATTAATG -> GCCATTAATGG
AGCCCTTTCCT -> GCCCTTTCCTC
AGCCCTTTGAT -> GCCCTTTGATT
AGCCGAACTAA -> GCCGAACTAAG
AGCCGAAGTGA -> GCCGAAGTGAC
AGCCTCTAATG -> GCCTCTAATGG
AGCCTGCACGG -> GCCTGCACGGC
AGCGAAGCAAA -> GCGAAGCAAAG
AGCGACGAGTT -> GCGACGAGTTG
AGCGAGGATGG -> GCGAGGATGGT
AGCGGCATCTG -> GCGGCATCTGT
AGCGTAGGTTT -> GCGTAGGTTTG
AGCGTGATGAG -> GCGTGATGAGG
AGCGTGCTGAC -> GCGTGCTGACT
AGCGTTACAAA -> GCGTTACAAAC
AGCGTTATTGG -> GCGTTATTGGT
AGCGTTCATCT -> GCGTTCATCTT
AGCGTTCTGAT -> GCGTTCTGATA
AGCTACATGAG -> GCTACATGAGG
AGCTATGTTTA -> GCTATGTTTAA
AGCTCCCATAT -> GCTCCCATATA
AGCTCTGTTTC -> GCTCTGTTTCA
AGCTTCTCCGA -> GCTTCTCCGAT
AGCTTTAGCCG -> GCTTTAGCCGA
AGCTTTCGCCT -> GCTTTCGCCTA
AGGAATGGGTC -> GGAATGGGTCT
AGGACAATCAA -> GGACAATCAAC
AGGACTCATGG -> GGACTCATGGT
AGGAGTTTAAG -> GGAGTTTAAGC
AGGAGTTTCCC -> GGAGTTTCCCG
AGGATCAAACA -> GGATCAAACAC
AGGATGGTAAA -> GGATGGTAAAA
AGGCAATCGAT -> GGCAATCGATT
AGGCACAATCT -> GGCACAATCTG
AGGCACCCATT -> GGCACCCATTG
AGGCAGGTGAA -> GGCAGGTGAAC
AGGCAGTACTG -> GGCAGTACTGG
AGGCCAATCGG -> GGCCAATCGGG
AGGCCCATTGG -> GGCCCATTGGA
AGGCCGGGACC -> GGCCGGGACCT
AGGCCGTATCG -> GGCCGTATCGG
AGGCGATCAAC -> GGCGATCAACG
AGGCGTTTCAT -> GGCGTTTCATT
AGGCTGCACCG -> GGCTGCACCGT
AGGCTTCCAGG -> GGCTTCCAGGT
AGGGAGACGGA -> GGGAGACGGAA
AGGGATATCTG -> GGGATATCTGG
AGGGCAATATA -> GGGCAATATAC
AGGGCCATACG -> GGGCCATACGC
AGGGCCGGCCC -> GGGCCGGCCCT
AGGGCCGTAGG -> GGGCCGTAGGC
AGGGGACCGAT -> GGGGACCGATA
AGGGGAGGCAG -> GGGGAGGCAGG
AGGGTGTTATT -> GGGTGTTATTT
AGGTAGATTGT -> GGTAGATTGTT
AGGTAGCGAAG -> GGTAGCGAAGC
AGGTATTTTTC -> GGTATTTTTCT
AGGTGAACTGT -> GGTGAACTGTC
AGGTGAGCGTT -> GGTGAGCGTTC
AGGTGCCACGT -> GGTGCCACGTA
AGGTGTAGGTA -> GGTGTAGGTAG
AGGTTCCGTAG -> GGTTCCGTAGA
AGGTTTGAAAG -> GGTTTGAAAGA
AGTACCAGAGT -> GTACCAGAGTG
AGTACTGGGAG -> GTACTGGGAGA
AGTAGATGGTA -> GTAGATGGTAG
AGTAGGTGCCA -> GTAGGTGCCAC
AGTATCGGAGT -> GTATCGGAGTA
AGTATTTATGA -> GTATTTATGAC
AGTCATGGGAT -> GTCATGGGATG
AGTCCCAGGGC -> GTCCCAGGGCA
AGTCCGACGCT -> GTCCGACGCTA
AGTCTAATAGG -> GTCTAATAGGA
AGTCTGCATAC -> GTCTGCATACA
AGTGACCGTAC -> GTGACCGTACG
AGTGCCTGGCC -> GTGCCTGGCCG
AGTGCTAAGCA -> GTGCTAAGCAC
AGTGCTGGGCC -> GTGCTGGGCCG
AGTGTCACGCT -> GTGTCACGCTA
AGTGTGCGCTG -> GTGTGCGCTGT
AGTGTTGATTA -> GTGTTGATTAG
AGTTACATAGG -> GTTACATAGGC
AGTTCACACAA -> GTTCACACAAG
AGTTCCATGAG -> GTTCCATGAGG
AGTTGAATACA -> GTTGAATACAA
AGTTGATATTT -> GTTGATATTTA
AGTTGGCTAGC -> GTTGGCTAGCT
AGTTTAAGCTA -> GTTTAAGCTAC
AGTTTCATGCC -> GTTTCATGCCC
AGTTTCCCGGG -> GTTTCCCGGGG
AGTTTGCCCGG -> GTTTGCCCGGT
ATAAAGATCTG -> TAAAGATCTGG
ATAAATTGATA -> TAAATTGATAT
ATAACTCACCT -> TAACTCACCTT
ATAAGAGCGTT -> TAAGAGCGTTA
ATAAGCCTGCA -> TAAGCCTGCAC
ATAATGTTTCT -> TAATGTTTCTA
ATAATTCATCC -> TAATTCATCCA
ATACAACGCTA -> TACAACGCTAG
ATACAATTAAT -> TACAATTAATT
ATACATCGTTC -> TACATCGTTCC
ATACGCGACGA -> TACGCGACGAG
ATACTACTATT -> TACTACTATTG
ATACTATAACT -> TACTATAACTC
ATACTTTGTGA -> TACTTTGTGAT
ATAGCGACGAG -> TAGCGACGAGT
ATAGCTTTAGC -> TAGCTTTAGCC
ATAGGAGTTTA -> TAGGAGTTTAA
ATAGGCAATCG -> TAGGCAATCGA
ATAGGCGATCA -> TAGGCGATCAA
ATAGGGAGACG -> TAGGGAGACGG
ATAGGGGAGGC -> TAGGGGAGGCA
ATAGGTGAGCG -> TAGGTGAGCGT
ATAGTACCAGA -> TAGTACCAGAG
ATAGTAGGTGC -> TAGTAGGTGCC
ATAGTATCGGA -> TAGTATCGGAG
ATAGTTTCATG -> TAGTTTCATGC
ATATACTATAA -> TATACTATAAC
ATATAGTAGGT -> TATAGTAGGTG
ATATCAGGCCG -> TATCAGGCCGG
ATATCTGGAAA -> TATCTGGAAAT
ATATGAGACAA -> TATGAGACAAA
ATATGATGGCT -> TATGATGGCTT
ATATGTAGTGT -> TATGTAGTGTC
ATATGTGTTAA -> TATGTGTTAAC
ATATTTAGGGT -> TATTTAGGGTG
ATATTTAGTTC -> TATTTAGTTCC
ATCAAACACCT -> TCAAACACCTC
ATCAACCAATG -> TCAACCAATGT
ATCAACGCTAG -> TCAACGCTAGA
ATCAAGAGACT -> TCAAGAGACTT
ATCACGGTCCT -> TCACGGTCCTT
ATCAGGCCGGG -> TCAGGCCGGGA
ATCATCGGGGT -> TCATCGGGGTC
ATCATTATTCC -> TCATTATTCCT
ATCCACGGGAT -> TCCACGGGATC
ATCCCTTATTC -> TCCCTTATTCA
ATCCTCTGTGT -> TCCTCTGTGTT
ATCCTGGAGAT -> TCCTGGAGATT
ATCGAGACGTT -> TCGAGACGTTC
ATCGATTGGGA -> TCGATTGGGAT
ATCGGAGTATT -> TCGGAGTATTT
ATCGGGACATC -> TCGGGACATCC
ATCGGGGTCAC -> TCGGGGTCACC
ATCGGTTAGTC -> TCGGTTAGTCA
ATCGTGCCATT -> TCGTGCCATTT
ATCGTTCCGAG -> TCGTTCCGAGT
ATCTCGCGCCA -> TCTCGCGCCAA
ATCTGCGTGTT -> TCTGCGTGTTA
ATCTGGAAATT -> TCTGGAAATTA
ATCTGGTTACT -> TCTGGTTACTC
ATCTGTAACTC -> TCTGTAACTCC
ATCTTACACCA -> TCTTACACCAG
ATGAATGCGCG -> TGAATGCGCGA
ATGACCCGCCG -> TGACCCGCCGC
ATGACGTGTCA -> TGACGTGTCAG
ATGAGACAAAT -> TGAGACAAATA
ATGAGGCACAA -> TGAGGCACAAT
ATGAGGCGTTT -> TGAGGCGTTTC
ATGAGGCTTCC -> TGAGGCTTCCA
ATGAGGGCCAT -> TGAGGGCCATA
ATGAGTAGATG -> TGAGTAGATGG
ATGATAGGTGA -> TGATAGGTGAG
ATGATGGCTTT -> TGATGGCTTTA
ATGCAGAGAGA -> TGCAGAGAGAA
ATGCATACAGC -> TGCATACAGCG
ATGCCCCCGGA -> TGCCCCCGGAT
ATGCGCCTATG -> TGCGCCTATGA
ATGCGCGATCG -> TGCGCGATCGA
ATGCTACGGGC -> TGCTACGGGCA
ATGCTCCAGAG -> TGCTCCAGAGG
ATGCTGAAACC -> TGCTGAAACCC
ATGCTGCATCG -> TGCTGCATCGT
ATGGACCCTGC -> TGGACCCTGCT
ATGGACTGAAA -> TGGACTGAAAC
ATGGCAAAGAC -> TGGCAAAGACA
ATGGCCCTCAA -> TGGCCCTCAAC
ATGGCTTTATC -> TGGCTTTATCA
ATGGGATGCTG -> TGGGATGCTGC
ATGGGTCTACA -> TGGGTCTACAC
ATGGTAAAAGC -> TGGTAAAAGCA
ATGGTAGGCCA -> TGGTAGGCCAA
ATGGTATGGAC -> TGGTATGGACT
ATGGTTAAGAT -> TGGTTAAGATT
ATGTAGTGTCA -> TGTAGTGTCAC
ATGTCAGTGCT -> TGTCAGTGCTG
ATGTGACAGTT -> TGTGACAGTTC
ATGTGTTAACG -> TGTGTTAACGC
ATGTTTAAGCG -> TGTTTAAGCGT
ATGTTTCTATC -> TGTTTCTATCA
ATTAATGGCAA -> TTAATGGCAAA
ATTAATTTGGG -> TTAATTTGGGC
ATTACCAAGCG -> TTACCAAGCGT
ATTACGGGGAC -> TTACGGGGACG
ATTAGCAAAAT -> TTAGCAAAATT
ATTAGCGAGGA -> TTAGCGAGGAT
ATTATTACGGG -> TTATTACGGGG
ATTATTCCTCC -> TTATTCCTCCC
ATTCAGAAGAT -> TTCAGAAGATG
ATTCATCCACG -> TTCATCCACGG
ATTCCGAAACA -> TTCCGAAACAA
ATTCCTCCCTT -> TTCCTCCCTTA
ATTCTTCGGGA -> TTCTTCGGGAG
ATTGAACAGGC -> TTGAACAGGCC
ATTGAGAGAAG -> TTGAGAGAAGT
ATTGATATTTA -> TTGATATTTAG
ATTGCAAACAT -> TTGCAAACATA
ATTGCACCCCT -> TTGCACCCCTC
ATTGCGCATGT -> TTGCGCATGTC
ATTGCTGTTCT -> TTGCTGTTCTC
ATTGCTTAAAT -> TTGCTTAAATA
ATTGGATAAAG -> TTGGATAAAGA
ATTGGATATGT -> TTGGATATGTA
ATTGGCTACGG -> TTGGCTACGGC
ATTGGGATTTC -> TTGGGATTTCG
ATTGGTCCGAT -> TTGGTCCGATA
ATTGTATGCAT -> TTGTATGCATA
ATTGTTAACAC -> TTGTTAACACA
ATTTACGGTTC -> TTTACGGTTCA
ATTTAGGGTGT -> TTTAGGGTGTT
ATTTAGTTCCA -> TTTAGTTCCAT
ATTTATGACGT -> TTTATGACGTG
ATTTCCGATAG -> TTTCCGATAGG
ATTTCCGGTCG -> TTTCCGGTCGT
ATTTCCTACTA -> TTTCCTACTAT
ATTTCGGGAGG -> TTTCGGGAGGA
ATTTGGGCGGT -> TTTGGGCGGTC
ATTTGTTAACT -> TTTGTTAACTA
ATTTTAGCAGC -> TTTTAGCAGCC
ATTTTTCTAAC -> TTTTTCTAACC
CAAAAATAATT -> AAAAATAATTC
CAAAAGGCAGT -> AAAAGGCAGTA
CAAAATTTCCT -> AAAATTTCCTA
CAAACACCTCG -> AAACACCTCGT
CAAACATACTT -> AAACATACTTT
CAAACCACGCC -> AAACCACGCCC
CAAAGACAATG -> AAAGACAATGG
CAAAGACGTCG -> AAAGACGTCGG
CAAAGCCCTTT -> AAAGCCCTTTG
CAAAGTTTGCC -> AAAGTTTGCCC
CAAATAGTATC -> AAATAGTATCG
CAACAAAAGGC -> AACAAAAGGCA
CAACCAATAAT -> AACCAATAATG
CAACCAATGTG -> AACCAATGTGA
CAACGCTAGAC -> AACGCTAGACG
CAACGCTAGGC -> AACGCTAGGCA
CAACTTGGGGC -> AACTTGGGGCC
CAAGAGACTTC -> AAGAGACTTCA
CAAGCGTAGGT -> AAGCGTAGGTT
CAAGCGTTCTG -> AAGCGTTCTGA
CAAGCTCCCAT -> AAGCTCCCATA
CAAGGATCAAA -> AAGGATCAAAC
CAAGGTATTTT -> AAGGTATTTTT
CAAGTTGAATA -> AAGTTGAATAC
CAATAATGTTT -> AATAATGTTTC
CAATATACTAT -> AATATACTATA
CAATCAACCAA -> AATCAACCAAT
CAATCGATTGG -> AATCGATTGGG
CAATCGGGACA -> AATCGGGACAT
CAATCTGCGTG -> AATCTGCGTGT
CAATGCAGAGA -> AATGCAGAGAG
CAATGGACCCT -> AATGGACCCTG
CAATGGCCCTC -> AATGGCCCTCA
CAATGTGACAG -> AATGTGACAGT
CAATTAATTTG -> AATTAATTTGG
CAATTACCAAG -> AATTACCAAGC
CACAAAAATAA -> ACAAAAATAAT
CACAAGTTGAA -> ACAAGTTGAAT
CACAATCTGCG -> ACAATCTGCGT
CACACAAGTTG -> ACACAAGTTGA
CACACTTGAGT -> ACACTTGAGTC
CACCAGCGTTA -> ACCAGCGTTAT
CACCCATTGAG -> ACCCATTGAGA
CACCCCTCCCA -> ACCCCTCCCAC
CACCGGATATG -> ACCGGATATGT
CACCGTCTGGG -> ACCGTCTGGGG
CACCTCGTTTG -> ACCTCGTTTGT
CACCTTACCGT -> ACCTTACCGTG
CACGATCCTGG -> ACGATCCTGGA
CACGATTCCGA -> ACGATTCCGAA
CACGCAAAGCC -> ACGCAAAGCCC
CACGCAAGGAT -> ACGCAAGGATC
CACGCCCACGC -> ACGCCCACGCA
CACGCTACTAG -> ACGCTACTAGC
CACGGCTAGCT -> ACGGCTAGCTT
CACGGGATCAT -> ACGGGATCATC
CACGGTCCTTC -> ACGGTCCTTCA
CACGTAACTAC -> ACGTAACTACA
CACTCGATTTG -> ACTCGATTTGT
CACTTAGCCAA -> ACTTAGCCAAA
CACTTGAGTCC -> ACTTGAGTCCC
CACTTGCGAAA -> ACTTGCGAAAT
CACTTTTTACC -> ACTTTTTACCA
CAGAAGAGGAA -> AGAAGAGGAAT
CAGAAGATGCT -> AGAAGATGCTG
CAGAGAGAATC -> AGAGAGAATCT
CAGAGGGGACC -> AGAGGGGACCG
CAGAGTGTTGA -> AGAGTGTTGAT
CAGCCCTTTCC -> AGCCCTTTCCT
CAGCGTTATTG -> AGCGTTATTGG
CAGGCCGGGAC -> AGGCCGGGACC
CAGGCCGTATC -> AGGCCGTATCG
CAGGGCAATAT -> AGGGCAATATA
CAGGGCCGGCC -> AGGGCCGGCCC
CAGGTGAACTG -> AGGTGAACTGT
CAGGTGTAGGT -> AGGTGTAGGTA
CAGTACTGGGA -> AGTACTGGGAG
CAGTCTAATAG -> AGTCTAATAGG
CAGTCTGCATA -> AGTCTGCATAC
CAGTGCTGGGC -> AGTGCTGGGCC
CAGTTCACACA -> AGTTCACACAA
CAGTTGGCTAG -> AGTTGGCTAGC
CATAAGCCTGC -> ATAAGCCTGCA
CATACATCGTT -> ATACATCGTTC
CATACGCGACG -> ATACGCGACGA
CATACTTTGTG -> ATACTTTGTGA
CATAGCGACGA -> ATAGCGACGAG
CATAGGCGATC -> ATAGGCGATCA
CATAGTTTCAT -> ATAGTTTCATG
CATATAGTAGG -> ATATAGTAGGT
CATCCACGGGA -> ATCCACGGGAT
CATCCCTTATT -> ATCCCTTATTC
CATCGGGGTCA -> ATCGGGGTCAC
CATCGTGCCAT -> ATCGTGCCATT
CATCGTTCCGA -> ATCGTTCCGAG
CATCTGTAACT -> ATCTGTAACTC
CATCTTACACC -> ATCTTACACCA
CATGAGGCACA -> ATGAGGCACAA
CATGAGGGCCA -> ATGAGGGCCAT
CATGAGTAGAT -> ATGAGTAGATG
CATGCCCCCGG -> ATGCCCCCGGA
CATGCTCCAGA -> ATGCTCCAGAG
CATGGGATGCT -> ATGGGATGCTG
CATGGTTAAGA -> ATGGTTAAGAT
CATGTCAGTGC -> ATGTCAGTGCT
CATTAATGGCA -> ATTAATGGCAA
CATTATTCCTC -> ATTATTCCTCC
CATTGAGAGAA -> ATTGAGAGAAG
CATTGCACCCC -> ATTGCACCCCT
CATTGGATAAA -> ATTGGATAAAG
CATTGGCTACG -> ATTGGCTACGG
CATTTCCGGTC -> ATTTCCGGTCG
CCAAAGACGTC -> CAAAGACGTCG
CCAACAAAAGG -> CAACAAAAGGC
CCAAGCGTAGG -> CAAGCGTAGGT
CCAAGGTATTT -> CAAGGTATTTT
CCAATAATGTT -> CAATAATGTTT
CCAATCGGGAC -> CAATCGGGACA
CCAATGTGACA -> CAATGTGACAG
CCACGCAAAGC -> CACGCAAAGCC
CCACGCCCACG -> CACGCCCACGC
CCACGGGATCA -> CACGGGATCAT
CCACGTAACTA -> CACGTAACTAC
CCACTCGATTT -> CACTCGATTTG
CCAGAAGAGGA -> CAGAAGAGGAA
CCAGAGGGGAC -> CAGAGGGGACC
CCAGAGTGTTG -> CAGAGTGTTGA
CCAGCGTTATT -> CAGCGTTATTG
CCAGGGCAATA -> CAGGGCAATAT
CCAGGTGTAGG -> CAGGTGTAGGT
CCATACGCGAC -> CATACGCGACG
CCATATAGTAG -> CATATAGTAGG
CCATGAGGCAC -> CATGAGGCACA
CCATGCTCCAG -> CATGCTCCAGA
CCATTAATGGC -> CATTAATGGCA
CCATTGAGAGA -> CATTGAGAGAA
CCATTGCACCC -> CATTGCACCCC
CCATTGGATAA -> CATTGGATAAA
CCATTTCCGGT -> CATTTCCGGTC
CCCACGCAAAG -> CCACGCAAAGC
CCCACTCGATT -> CCACTCGATTT
CCCAGAAGAGG -> CCAGAAGAGGA
CCCAGGGCAAT -> CCAGGGCAATA
CCCATATAGTA -> CCATATAGTAG
CCCATTGAGAG -> CCATTGAGAGA
CCCATTGGATA -> CCATTGGATAA
CCCCCGGATTG -> CCCCGGATTGC
CCCCGAGGTAG -> CCCGAGGTAGC
CCCCGGATTGC -> CCCGGATTGCG
CCCCTCCCACT -> CCCTCCCACTC
CCCGAGGTAGC -> CCGAGGTAGCG
CCCGCCGCTTC -> CCGCCGCTTCG
CCCGGATTGCG -> CCGGATTGCGC
CCCGGGGGGAA -> CCGGGGGGAAA
CCCGGTCCTAT -> CCGGTCCTATT
CCCTAGCCATT -> CCTAGCCATTA
CCCTCAACTTG -> CCTCAACTTGG
CCCTCCCACTC -> CCTCCCACTCG
CCCTGCTCCTC -> CCTGCTCCTCA
CCCTTACCTCG -> CCTTACCTCGG
CCCTTATTCAG -> CCTTATTCAGA
CCCTTTCCTCG -> CCTTTCCTCGC
CCCTTTGATTG -> CCTTTGATTGT
CCGAAACAATT -> CGAAACAATTA
CCGAACTAAGG -> CGAACTAAGGT
CCGAAGTGACC -> CGAAGTGACCG
CCGACGCTATT -> CGACGCTATTT
CCGAGATGATA -> CGAGATGATAG
CCGAGGTAGCG -> CGAGGTAGCGA
CCGAGTCCGAC -> CGAGTCCGACG
CCGATAGGCAA -> CGATAGGCAAT
CCGATATCAGG -> CGATATCAGGC
CCGATATGATG -> CGATATGATGG
CCGATTGCTGT -> CGATTGCTGTT
CCGCCGCTTCG -> CGCCGCTTCGG
CCGCGACTTGC -> CGCGACTTGCC
CCGCTTCGGTG -> CGCTTCGGTGC
CCGGACATAGC -> CGGACATAGCG
CCGGACCCAGA -> CGGACCCAGAA
CCGGATATGTG -> CGGATATGTGT
CCGGATTGCGC -> CGGATTGCGCA
CCGGCAAGCTC -> CGGCAAGCTCC
CCGGCCCTAGC -> CGGCCCTAGCC
CCGGGACCTGT -> CGGGACCTGTC
CCGGGGGGAAA -> CGGGGGGAAAA
CCGGTCCTATT -> CGGTCCTATTA
CCGGTCGTTTA -> CGGTCGTTTAT
CCGGTTAAGAT -> CGGTTAAGATT
CCGTACGGTCA -> CGTACGGTCAG
CCGTAGACGGT -> CGTAGACGGTA
CCGTAGGCCCA -> CGTAGGCCCAT
CCGTATCGGTT -> CGTATCGGTTA
CCGTCTGGGGG -> CGTCTGGGGGT
CCGTGACTCTT -> CGTGACTCTTA
CCGTGTGGTTT -> CGTGTGGTTTA
CCGTTGGCGCT -> CGTTGGCGCTC
CCGTTTTTCTC -> CGTTTTTCTCA
CCTACTATAGC -> CTACTATAGCT
CCTAGCCATTA -> CTAGCCATTAA
CCTAGGAGTTT -> CTAGGAGTTTC
CCTATAAATTG -> CTATAAATTGA
CCTATGACCCG -> CTATGACCCGC
CCTATTATTAC -> CTATTATTACG
CCTCAACTTGG -> CTCAACTTGGG
CCTCAGTCTAA -> CTCAGTCTAAT
CCTCCCACTCG -> CTCCCACTCGA
CCTCCCTTACC -> CTCCCTTACCT
CCTCGCAGTCT -> CTCGCAGTCTG
CCTCGGGTACG -> CTCGGGTACGC
CCTCGTTTGTC -> CTCGTTTGTCT
CCTCTAATGGT -> CTCTAATGGTA
CCTCTGTGTTT -> CTCTGTGTTTG
CCTGCACGGCT -> CTGCACGGCTA
CCTGCTCCTCA -> CTGCTCCTCAG
CCTGGAGATTG -> CTGGAGATTGC
CCTGGCCGGAC -> CTGGCCGGACC
CCTGTCATAGT -> CTGTCATAGTT
CCTTACCGTGT -> CTTACCGTGTG
CCTTACCTCGG -> CTTACCTCGGG
CCTTAGGGCCG -> CTTAGGGCCGT
CCTTATTCAGA -> CTTATTCAGAA
CCTTCACTTTT -> CTTCACTTTTT
CCTTTCCTCGC -> CTTTCCTCGCA
CCTTTGATTGT -> CTTTGATTGTA
CGAAACAATTA -> GAAACAATTAC
CGAAATTCTTC -> GAAATTCTTCG
CGAACTAAGGT -> GAACTAAGGTT
CGAAGCAAAGT -> GAAGCAAAGTT
CGAAGTGACCG -> GAAGTGACCGT
CGAATTTTAGC -> GAATTTTAGCA
CGACGAGGGAT -> GACGAGGGATA
CGACGAGTTGA -> GACGAGTTGAT
CGACGCTATTT -> GACGCTATTTA
CGACTTGCCGT -> GACTTGCCGTT
CGAGACGTTCA -> GAGACGTTCAA
CGAGATGATAG -> GAGATGATAGG
CGAGCTCTGTT -> GAGCTCTGTTT
CGAGGATGGTA -> GAGGATGGTAA
CGAGGGATATC -> GAGGGATATCT
CGAGGTAGCGA -> GAGGTAGCGAA
CGAGTCCGACG -> GAGTCCGACGC
CGAGTTGATAT -> GAGTTGATATT
CGATAGGCAAT -> GATAGGCAATC
CGATATCAGGC -> GATATCAGGCC
CGATATGATGG -> GATATGATGGC
CGATCAACGCT -> GATCAACGCTA
CGATCCTGGAG -> GATCCTGGAGA
CGATCGAGACG -> GATCGAGACGT
CGATTCCGAAA -> GATTCCGAAAC
CGATTGCTGTT -> GATTGCTGTTC
CGATTGGGATT -> GATTGGGATTT
CGATTTGTTAA -> GATTTGTTAAC
CGCAAAGCCCT -> GCAAAGCCCTT
CGCAAGGATCA -> GCAAGGATCAA
CGCAGTCTGCA -> GCAGTCTGCAT
CGCATGTCAGT -> GCATGTCAGTG
CGCCAAGGTAT -> GCCAAGGTATT
CGCCCACGCAA -> GCCCACGCAAA
CGCCGCTTCGG -> GCCGCTTCGGT
CGCCGGTTAAG -> GCCGGTTAAGA
CGCCGTGACTC -> GCCGTGACTCT
CGCCTATAAAT -> GCCTATAAATT
CGCCTATGACC -> GCCTATGACCC
CGCCTTAGGGC -> GCCTTAGGGCC
CGCGACGAGGG -> GCGACGAGGGA
CGCGACTTGCC -> GCGACTTGCCG
CGCGATCGAGA -> GCGATCGAGAC
CGCGCCAAGGT -> GCGCCAAGGTA
CGCGTTCCAAC -> GCGTTCCAACA
CGCTACTAGCC -> GCTACTAGCCG
CGCTAGACGAA -> GCTAGACGAAT
CGCTAGGCACC -> GCTAGGCACCC
CGCTATTTACG -> GCTATTTACGG
CGCTCTTTAGC -> GCTCTTTAGCC
CGCTGTCTCCG -> GCTGTCTCCGG
CGCTTCGGTGC -> GCTTCGGTGCC
CGGAAGATGAG -> GGAAGATGAGG
CGGACATAGCG -> GGACATAGCGA
CGGACCCAGAA -> GGACCCAGAAG
CGGAGGACAAT -> GGAGGACAATC
CGGAGTATTTA -> GGAGTATTTAT
CGGATATGTGT -> GGATATGTGTT
CGGATTGCGCA -> GGATTGCGCAT
CGGCAAGCTCC -> GGCAAGCTCCC
CGGCATCTGTA -> GGCATCTGTAA
CGGCCCTAGCC -> GGCCCTAGCCA
CGGCGTCGGAG -> GGCGTCGGAGG
CGGCTAGCTTC -> GGCTAGCTTCT
CGGGACATCCC -> GGGACATCCCT
CGGGACCTGTC -> GGGACCTGTCA
CGGGAGGACTC -> GGGAGGACTCA
CGGGAGTTACA -> GGGAGTTACAT
CGGGATCATCG -> GGGATCATCGG
CGGGCACTTGC -> GGGCACTTGCG
CGGGGACGTCT -> GGGGACGTCTG
CGGGGGGAAAA -> GGGGGGAAAAC
CGGGGTCACCG -> GGGGTCACCGG
CGGGTACGCCG -> GGGTACGCCGG
CGGTACGTATC -> GGTACGTATCA
CGGTAGAGTGC -> GGTAGAGTGCC
CGGTCAGTTGG -> GGTCAGTTGGC
CGGTCCGCGAC -> GGTCCGCGACT
CGGTCCTATTA -> GGTCCTATTAT
CGGTCCTTCAC -> GGTCCTTCACT
CGGTCGTTTAT -> GGTCGTTTATA
CGGTGCCGTTT -> GGTGCCGTTTT
CGGTTAAGATT -> GGTTAAGATTG
CGGTTAGTCAT -> GGTTAGTCATG
CGGTTCAATGG -> GGTTCAATGGC
CGTAACTACAT -> GTAACTACATA
CGTACGGTCAG -> GTACGGTCAGT
CGTAGACGGTA -> GTAGACGGTAG
CGTAGGCCCAT -> GTAGGCCCATT
CGTAGGTTTGA -> GTAGGTTTGAA
CGTATCAAGAG -> GTATCAAGAGA
CGTATCGGTTA -> GTATCGGTTAG
CGTCGGAGGAC -> GTCGGAGGACA
CGTCGGTACGT -> GTCGGTACGTA
CGTCTGATCCT -> GTCTGATCCTC
CGTCTGGGGGT -> GTCTGGGGGTT
CGTGACTCTTA -> GTGACTCTTAA
CGTGATGAGGC -> GTGATGAGGCG
CGTGCCATTTC -> GTGCCATTTCC
CGTGCTGACTG -> GTGCTGACTGA
CGTGTCAGGGC -> GTGTCAGGGCC
CGTGTGGTTTA -> GTGTGGTTTAG
CGTGTTACGTT -> GTGTTACGTTG
CGTTACAAACC -> GTTACAAACCA
CGTTATTGGTC -> GTTATTGGTCC
CGTTCAACCAA -> GTTCAACCAAT
CGTTCATCTTA -> GTTCATCTTAC
CGTTCCAACAA -> GTTCCAACAAA
CGTTCCGAGTC -> GTTCCGAGTCC
CGTTCTGATAG -> GTTCTGATAGT
CGTTGGCGCCT -> GTTGGCGCCTT
CGTTGGCGCTC -> GTTGGCGCTCT
CGTTGTCTGTC -> GTTGTCTGTCT
CGTTTATATGA -> GTTTATATGAG
CGTTTCATTGG -> GTTTCATTGGC
CGTTTGTCTAG -> GTTTGTCTAGT
CGTTTTTCTCA -> GTTTTTCTCAT
CTAACCGAGAT -> TAACCGAGATG
CTAAGCACTTA -> TAAGCACTTAG
CTAAGGTTCCG -> TAAGGTTCCGT
CTAATAGGAGT -> TAATAGGAGTT
CTAATGGTATG -> TAATGGTATGG
CTACACGCAAG -> TACACGCAAGG
CTACATAAGCC -> TACATAAGCCT
CTACATGAGGG -> TACATGAGGGC
CTACGGCGTCG -> TACGGCGTCGG
CTACGGGCACT -> TACGGGCACTT
CTACTAGCCGA -> TACTAGCCGAA
CTACTATAGCT -> TACTATAGCTT
CTACTATTGGA -> TACTATTGGAT
CTAGACGAATT -> TAGACGAATTT
CTAGCCATTAA -> TAGCCATTAAT
CTAGCCGAAGT -> TAGCCGAAGTG
CTAGCTATGTT -> TAGCTATGTTT
CTAGCTTCTCC -> TAGCTTCTCCG
CTAGGAGTTTC -> TAGGAGTTTCC
CTAGGCACCCA -> TAGGCACCCAT
CTAGTGTGCGC -> TAGTGTGCGCT
CTATAAATTGA -> TATAAATTGAT
CTATAACTCAC -> TATAACTCACC
CTATAGCTTTA -> TATAGCTTTAG
CTATAGGGAGA -> TATAGGGAGAC
CTATCACGGTC -> TATCACGGTCC
CTATGACCCGC -> TATGACCCGCC
CTATGTTTAAG -> TATGTTTAAGC
CTATTATTACG -> TATTATTACGG
CTATTGGATAT -> TATTGGATATG
CTATTTACGGT -> TATTTACGGTT
CTCAACTTGGG -> TCAACTTGGGG
CTCAAGCGTTC -> TCAAGCGTTCT
CTCACCTTACC -> TCACCTTACCG
CTCAGTCTAAT -> TCAGTCTAATA
CTCATGAGTAG -> TCATGAGTAGA
CTCATGGTTAA -> TCATGGTTAAG
CTCCAGAGGGG -> TCCAGAGGGGA
CTCCCACTCGA -> TCCCACTCGAT
CTCCCATATAG -> TCCCATATAGT
CTCCCTTACCT -> TCCCTTACCTC
CTCCGATTGCT -> TCCGATTGCTG
CTCCGGACATA -> TCCGGACATAG
CTCCTAGGAGT -> TCCTAGGAGTT
CTCCTCAGTCT -> TCCTCAGTCTA
CTCGATTTGTT -> TCGATTTGTTA
CTCGCAGTCTG -> TCGCAGTCTGC
CTCGCGCCAAG -> TCGCGCCAAGG
CTCGGGTACGC -> TCGGGTACGCC
CTCGTTTGTCT -> TCGTTTGTCTA
CTCTAATGGTA -> TCTAATGGTAT
CTCTGAAGCGG -> TCTGAAGCGGC
CTCTGTGTTTG -> TCTGTGTTTGG
CTCTGTTTCAC -> TCTGTTTCACG
CTCTTAATGCG -> TCTTAATGCGC
CTCTTTAGCCT -> TCTTTAGCCTC
CTGAAACCCCG -> TGAAACCCCGA
CTGAAACTTTC -> TGAAACTTTCG
CTGAAATACAA -> TGAAATACAAT
CTGAAGCGGCA -> TGAAGCGGCAT
CTGAAGGCTGC -> TGAAGGCTGCA
CTGACTGAAAT -> TGACTGAAATA
CTGATAGTACC -> TGATAGTACCA
CTGATCCTCTG -> TGATCCTCTGT
CTGCACCGTCT -> TGCACCGTCTG
CTGCACGGCTA -> TGCACGGCTAG
CTGCATACATC -> TGCATACATCG
CTGCATCGTGC -> TGCATCGTGCC
CTGCGTGTTAC -> TGCGTGTTACG
CTGCTCCTCAG -> TGCTCCTCAGT
CTGGAAATTAG -> TGGAAATTAGC
CTGGAGATTGC -> TGGAGATTGCT
CTGGCCGGACC -> TGGCCGGACCC
CTGGGAGAATA -> TGGGAGAATAG
CTGGGCCGGCA -> TGGGCCGGCAA
CTGGGGCGTTG -> TGGGGCGTTGG
CTGGGGGTTGG -> TGGGGGTTGGA
CTGGTTACTCA -> TGGTTACTCAA
CTGTAACTCCT -> TGTAACTCCTA
CTGTCACACTT -> TGTCACACTTG
CTGTCATAGTT -> TGTCATAGTTT
CTGTCTCCGGA -> TGTCTCCGGAC
CTGTCTGAAGG -> TGTCTGAAGGC
CTGTGTTTGGA -> TGTGTTTGGAT
CTGTTCTCTGA -> TGTTCTCTGAA
CTGTTTCACGA -> TGTTTCACGAT
CTTAAATAAGA -> TTAAATAAGAG
CTTAATGCGCC -> TTAATGCGCCT
CTTACACCAGC -> TTACACCAGCG
CTTACCGTGTG -> TTACCGTGTGG
CTTACCTCGGG -> TTACCTCGGGT
CTTAGCCAAAG -> TTAGCCAAAGA
CTTAGGGCCGT -> TTAGGGCCGTA
CTTATTCAGAA -> TTATTCAGAAG
CTTCAATGCAG -> TTCAATGCAGA
CTTCACTTTTT -> TTCACTTTTTA
CTTCCAGGTGT -> TTCCAGGTGTA
CTTCGGGAGTT -> TTCGGGAGTTA
CTTCGGTGCCG -> TTCGGTGCCGT
CTTCTCCGATT -> TTCTCCGATTG
CTTGAGTCCCA -> TTGAGTCCCAG
CTTGCCGTTGG -> TTGCCGTTGGC
CTTGCGAAATT -> TTGCGAAATTC
CTTGGGGCCAT -> TTGGGGCCATG
CTTTAGCCGAA -> TTTAGCCGAAC
CTTTAGCCTCT -> TTTAGCCTCTA
CTTTATCATTA -> TTTATCATTAT
CTTTCCTCGCA -> TTTCCTCGCAG
CTTTCGCCGTG -> TTTCGCCGTGA
CTTTCGCCTAT -> TTTCGCCTATA
CTTTGATTGTA -> TTTGATTGTAT
CTTTGTGATAC -> TTTGTGATACT
CTTTTTACCAT -> TTTTTACCATT
GAAAACTGGGG -> AAAACTGGGGC
GAAACAATTAC -> AAACAATTACC
GAAACCCCGAG -> AAACCCCGAGG
GAAACTTTCGC -> AAACTTTCGCC
GAAAGACGAGC -> AAAGACGAGCT
GAAATACAATT -> AAATACAATTA
GAAATTAGCGA -> AAATTAGCGAG
GAAATTCTTCG -> AAATTCTTCGG
GAACAGGCCGT -> AACAGGCCGTA
GAACTAAGGTT -> AACTAAGGTTC
GAACTGTCACA -> AACTGTCACAC
GAAGAGGAATG -> AAGAGGAATGG
GAAGATGAGGC -> AAGATGAGGCT
GAAGATGCTGA -> AAGATGCTGAA
GAAGCAAAGTT -> AAGCAAAGTTT
GAAGCGGCATC -> AAGCGGCATCT
GAAGGCTGCAC -> AAGGCTGCACC
GAAGTGACCGT -> AAGTGACCGTA
GAAGTGCTAAG -> AAGTGCTAAGC
GAATACAACGC -> AATACAACGCT
GAATAGGGGAG -> AATAGGGGAGG
GAATCTCGCGC -> AATCTCGCGCC
GAATGCGCGAT -> AATGCGCGATC
GAATGGGTCTA -> AATGGGTCTAC
GAATTTTAGCA -> AATTTTAGCAG
GACAAATAGTA -> ACAAATAGTAT
GACAATCAACC -> ACAATCAACCA
GACAATGGACC -> ACAATGGACCC
GACAGTTCACA -> ACAGTTCACAC
GACATAGCGAC -> ACATAGCGACG
GACATCCCTTA -> ACATCCCTTAT
GACCCAGAAGA -> ACCCAGAAGAG
GACCCGCCGCT -> ACCCGCCGCTT
GACCCTGCTCC -> ACCCTGCTCCT
GACCGATATCA -> ACCGATATCAG
GACCGTACGGT -> ACCGTACGGTC
GACCTGTCATA -> ACCTGTCATAG
GACGAATTTTA -> ACGAATTTTAG
GACGAGCTCTG -> ACGAGCTCTGT
GACGAGGGATA -> ACGAGGGATAT
GACGAGTTGAT -> ACGAGTTGATA
GACGCTATTTA -> ACGCTATTTAC
GACGGAAGATG -> ACGGAAGATGA
GACGGTAGAGT -> ACGGTAGAGTG
GACGTCGGTAC -> ACGTCGGTACG
GACGTCTGATC -> ACGTCTGATCC
GACGTGTCAGG -> ACGTGTCAGGG
GACGTTCAACC -> ACGTTCAACCA
GACTCATGGTT -> ACTCATGGTTA
GACTCTTAATG -> ACTCTTAATGC
GACTGAAACTT -> ACTGAAACTTT
GACTGAAATAC -> ACTGAAATACA
GACTTCAATGC -> ACTTCAATGCA
GACTTGCCGTT -> ACTTGCCGTTG
GAGAAGTGCTA -> AGAAGTGCTAA
GAGAATAGGGG -> AGAATAGGGGA
GAGAATCTCGC -> AGAATCTCGCG
GAGACAAATAG -> AGACAAATAGT
GAGACGGAAGA -> AGACGGAAGAT
GAGACGTTCAA -> AGACGTTCAAC
GAGACTTCAAT -> AGACTTCAATG
GAGAGAAGTGC -> AGAGAAGTGCT
GAGAGAATCTC -> AGAGAATCTCG
GAGATGATAGG -> AGATGATAGGT
GAGATTGCTTA -> AGATTGCTTAA
GAGCGTTACAA -> AGCGTTACAAA
GAGCGTTCATC -> AGCGTTCATCT
GAGCTCTGTTT -> AGCTCTGTTTC
GAGGAATGGGT -> AGGAATGGGTC
GAGGACAATCA -> AGGACAATCAA
GAGGACTCATG -> AGGACTCATGG
GAGGATGGTAA -> AGGATGGTAAA
GAGGCACAATC -> AGGCACAATCT
GAGGCAGGTGA -> AGGCAGGTGAA
GAGGCGTTTCA -> AGGCGTTTCAT
GAGGCTTCCAG -> AGGCTTCCAGG
GAGGGATATCT -> AGGGATATCTG
GAGGGCCATAC -> AGGGCCATACG
GAGGGGACCGA -> AGGGGACCGAT
GAGGTAGCGAA -> AGGTAGCGAAG
GAGTAGATGGT -> AGTAGATGGTA
GAGTATTTATG -> AGTATTTATGA
GAGTCCCAGGG -> AGTCCCAGGGC
GAGTCCGACGC -> AGTCCGACGCT
GAGTGCCTGGC -> AGTGCCTGGCC
GAGTGTTGATT -> AGTGTTGATTA
GAGTTACATAG -> AGTTACATAGG
GAGTTGATATT -> AGTTGATATTT
GAGTTTAAGCT -> AGTTTAAGCTA
GAGTTTCCCGG -> AGTTTCCCGGG
GATAAAGATCT -> ATAAAGATCTG
GATACTACTAT -> ATACTACTATT
GATAGGCAATC -> ATAGGCAATCG
GATAGGTGAGC -> ATAGGTGAGCG
GATAGTACCAG -> ATAGTACCAGA
GATATCAGGCC -> ATATCAGGCCG
GATATCTGGAA -> ATATCTGGAAA
GATATGATGGC -> ATATGATGGCT
GATATGTAGTG -> ATATGTAGTGT
GATATGTGTTA -> ATATGTGTTAA
GATATTTAGGG -> ATATTTAGGGT
GATATTTAGTT -> ATATTTAGTTC
GATCAAACACC -> ATCAAACACCT
GATCAACGCTA -> ATCAACGCTAG
GATCATCGGGG -> ATCATCGGGGT
GATCCTCTGTG -> ATCCTCTGTGT
GATCCTGGAGA -> ATCCTGGAGAT
GATCGAGACGT -> ATCGAGACGTT
GATCTGGTTAC -> ATCTGGTTACT
GATGAATGCGC -> ATGAATGCGCG
GATGAGGCGTT -> ATGAGGCGTTT
GATGAGGCTTC -> ATGAGGCTTCC
GATGATAGGTG -> ATGATAGGTGA
GATGCTACGGG -> ATGCTACGGGC
GATGCTGAAAC -> ATGCTGAAACC
GATGCTGCATC -> ATGCTGCATCG
GATGGCTTTAT -> ATGGCTTTATC
GATGGTAAAAG -> ATGGTAAAAGC
GATGGTAGGCC -> ATGGTAGGCCA
GATTAGCAAAA -> ATTAGCAAAAT
GATTCCGAAAC -> ATTCCGAAACA
GATTGAACAGG -> ATTGAACAGGC
GATTGCAAACA -> ATTGCAAACAT
GATTGCGCATG -> ATTGCGCATGT
GATTGCTGTTC -> ATTGCTGTTCT
GATTGCTTAAA -> ATTGCTTAAAT
GATTGGGATTT -> ATTGGGATTTC
GATTGTATGCA -> ATTGTATGCAT
GATTGTTAACA -> ATTGTTAACAC
GATTTCGGGAG -> ATTTCGGGAGG
GATTTGTTAAC -> ATTTGTTAACT
GCAAAATTTCC -> CAAAATTTCCT
GCAAACATACT -> CAAACATACTT
GCAAAGACAAT -> CAAAGACAATG
GCAAAGCCCTT -> CAAAGCCCTTT
GCAAAGTTTGC -> CAAAGTTTGCC
GCAAGCTCCCA -> CAAGCTCCCAT
GCAAGGATCAA -> CAAGGATCAAA
GCAATATACTA -> CAATATACTAT
GCAATCGATTG -> CAATCGATTGG
GCACAATCTGC -> CACAATCTGCG
GCACCCATTGA -> CACCCATTGAG
GCACCCCTCCC -> CACCCCTCCCA
GCACCGTCTGG -> CACCGTCTGGG
GCACGATTCCG -> CACGATTCCGA
GCACGGCTAGC -> CACGGCTAGCT
GCACTTAGCCA -> CACTTAGCCAA
GCACTTGCGAA -> CACTTGCGAAA
GCAGAGAGAAT -> CAGAGAGAATC
GCAGCCCTTTC -> CAGCCCTTTCC
GCAGGTGAACT -> CAGGTGAACTG
GCAGTACTGGG -> CAGTACTGGGA
GCAGTCTGCAT -> CAGTCTGCATA
GCATACATCGT -> CATACATCGTT
GCATCGTGCCA -> CATCGTGCCAT
GCATCTGTAAC -> CATCTGTAACT
GCATGTCAGTG -> CATGTCAGTGC
GCCAAAGACGT -> CCAAAGACGTC
GCCAAGGTATT -> CCAAGGTATTT
GCCAATCGGGA -> CCAATCGGGAC
GCCACGTAACT -> CCACGTAACTA
GCCATACGCGA -> CCATACGCGAC
GCCATGCTCCA -> CCATGCTCCAG
GCCATTAATGG -> CCATTAATGGC
GCCATTTCCGG -> CCATTTCCGGT
GCCCACGCAAA -> CCCACGCAAAG
GCCCATTGGAT -> CCCATTGGATA
GCCCCCGGATT -> CCCCCGGATTG
GCCCGGTCCTA -> CCCGGTCCTAT
GCCCTAGCCAT -> CCCTAGCCATT
GCCCTCAACTT -> CCCTCAACTTG
GCCCTTTCCTC -> CCCTTTCCTCG
GCCCTTTGATT -> CCCTTTGATTG
GCCGAACTAAG -> CCGAACTAAGG
GCCGAAGTGAC -> CCGAAGTGACC
GCCGCTTCGGT -> CCGCTTCGGTG
GCCGGACCCAG -> CCGGACCCAGA
GCCGGCAAGCT -> CCGGCAAGCTC
GCCGGCCCTAG -> CCGGCCCTAGC
GCCGGGACCTG -> CCGGGACCTGT
GCCGGTTAAGA -> CCGGTTAAGAT
GCCGTAGGCCC -> CCGTAGGCCCA
GCCGTATCGGT -> CCGTATCGGTT
GCCGTGACTCT -> CCGTGACTCTT
GCCGTTGGCGC -> CCGTTGGCGCT
GCCGTTTTTCT -> CCGTTTTTCTC
GCCTATAAATT -> CCTATAAATTG
GCCTATGACCC -> CCTATGACCCG
GCCTCTAATGG -> CCTCTAATGGT
GCCTGCACGGC -> CCTGCACGGCT
GCCTGGCCGGA -> CCTGGCCGGAC
GCCTTAGGGCC -> CCTTAGGGCCG
GCGAAATTCTT -> CGAAATTCTTC
GCGAAGCAAAG -> CGAAGCAAAGT
GCGACGAGGGA -> CGACGAGGGAT
GCGACGAGTTG -> CGACGAGTTGA
GCGACTTGCCG -> CGACTTGCCGT
GCGAGGATGGT -> CGAGGATGGTA
GCGATCAACGC -> CGATCAACGCT
GCGATCGAGAC -> CGATCGAGACG
GCGCATGTCAG -> CGCATGTCAGT
GCGCCAAGGTA -> CGCCAAGGTAT
GCGCCTATGAC -> CGCCTATGACC
GCGCCTTAGGG -> CGCCTTAGGGC
GCGCGATCGAG -> CGCGATCGAGA
GCGCTCTTTAG -> CGCTCTTTAGC
GCGCTGTCTCC -> CGCTGTCTCCG
GCGGCATCTGT -> CGGCATCTGTA
GCGGTCCGCGA -> CGGTCCGCGAC
GCGTAGGTTTG -> CGTAGGTTTGA
GCGTCGGAGGA -> CGTCGGAGGAC
GCGTGATGAGG -> CGTGATGAGGC
GCGTGCTGACT -> CGTGCTGACTG
GCGTGTTACGT -> CGTGTTACGTT
GCGTTACAAAC -> CGTTACAAACC
GCGTTATTGGT -> CGTTATTGGTC
GCGTTCATCTT -> CGTTCATCTTA
GCGTTCCAACA -> CGTTCCAACAA
GCGTTCTGATA -> CGTTCTGATAG
GCGTTGGCGCC -> CGTTGGCGCCT
GCGTTTCATTG -> CGTTTCATTGG
GCTAAGCACTT -> CTAAGCACTTA
GCTACATGAGG -> CTACATGAGGG
GCTACGGCGTC -> CTACGGCGTCG
GCTACGGGCAC -> CTACGGGCACT
GCTACTAGCCG -> CTACTAGCCGA
GCTAGACGAAT -> CTAGACGAATT
GCTAGCTATGT -> CTAGCTATGTT
GCTAGCTTCTC -> CTAGCTTCTCC
GCTAGGCACCC -> CTAGGCACCCA
GCTATGTTTAA -> CTATGTTTAAG
GCTATTTACGG -> CTATTTACGGT
GCTCCAGAGGG -> CTCCAGAGGGG
GCTCCCATATA -> CTCCCATATAG
GCTCCTCAGTC -> CTCCTCAGTCT
GCTCTGTTTCA -> CTCTGTTTCAC
GCTCTTTAGCC -> CTCTTTAGCCT
GCTGAAACCCC -> CTGAAACCCCG
GCTGACTGAAA -> CTGACTGAAAT
GCTGCACCGTC -> CTGCACCGTCT
GCTGCATCGTG -> CTGCATCGTGC
GCTGGGCCGGC -> CTGGGCCGGCA
GCTGTCTCCGG -> CTGTCTCCGGA
GCTGTTCTCTG -> CTGTTCTCTGA
GCTTAAATAAG -> CTTAAATAAGA
GCTTCCAGGTG -> CTTCCAGGTGT
GCTTCGGTGCC -> CTTCGGTGCCG
GCTTCTCCGAT -> CTTCTCCGATT
GCTTTAGCCGA -> CTTTAGCCGAA
GCTTTATCATT -> CTTTATCATTA
GCTTTCGCCTA -> CTTTCGCCTAT
GGAAAACTGGG -> GAAAACTGGGG
GGAAATTAGCG -> GAAATTAGCGA
GGAAGATGAGG -> GAAGATGAGGC
GGAATGGGTCT -> GAATGGGTCTA
GGACAATCAAC -> GACAATCAACC
GGACATAGCGA -> GACATAGCGAC
GGACATCCCTT -> GACATCCCTTA
GGACCCAGAAG -> GACCCAGAAGA
GGACCCTGCTC -> GACCCTGCTCC
GGACCGATATC -> GACCGATATCA
GGACCTGTCAT -> GACCTGTCATA
GGACGTCTGAT -> GACGTCTGATC
GGACTCATGGT -> GACTCATGGTT
GGACTGAAACT -> GACTGAAACTT
GGAGAATAGGG -> GAGAATAGGGG
GGAGACGGAAG -> GAGACGGAAGA
GGAGATTGCTT -> GAGATTGCTTA
GGAGGACAATC -> GAGGACAATCA
GGAGGACTCAT -> GAGGACTCATG
GGAGGCAGGTG -> GAGGCAGGTGA
GGAGTATTTAT -> GAGTATTTATG
GGAGTTACATA -> GAGTTACATAG
GGAGTTTAAGC -> GAGTTTAAGCT
GGAGTTTCCCG -> GAGTTTCCCGG
GGATAAAGATC -> GATAAAGATCT
GGATATCTGGA -> GATATCTGGAA
GGATATGTAGT -> GATATGTAGTG
GGATATGTGTT -> GATATGTGTTA
GGATCAAACAC -> GATCAAACACC
GGATCATCGGG -> GATCATCGGGG
GGATGAATGCG -> GATGAATGCGC
GGATGCTACGG -> GATGCTACGGG
GGATGCTGCAT -> GATGCTGCATC
GGATGGTAAAA -> GATGGTAAAAG
GGATTGCGCAT -> GATTGCGCATG
GGATTTCGGGA -> GATTTCGGGAG
GGCAAAGACAA -> GCAAAGACAAT
GGCAAGCTCCC -> GCAAGCTCCCA
GGCAATATACT -> GCAATATACTA
GGCAATCGATT -> GCAATCGATTG
GGCACAATCTG -> GCACAATCTGC
GGCACCCATTG -> GCACCCATTGA
GGCACTTGCGA -> GCACTTGCGAA
GGCAGGTGAAC -> GCAGGTGAACT
GGCAGTACTGG -> GCAGTACTGGG
GGCATCTGTAA -> GCATCTGTAAC
GGCCAATCGGG -> GCCAATCGGGA
GGCCATACGCG -> GCCATACGCGA
GGCCATGCTCC -> GCCATGCTCCA
GGCCCATTGGA -> GCCCATTGGAT
GGCCCTAGCCA -> GCCCTAGCCAT
GGCCCTCAACT -> GCCCTCAACTT
GGCCGGACCCA -> GCCGGACCCAG
GGCCGGCAAGC -> GCCGGCAAGCT
GGCCGGCCCTA -> GCCGGCCCTAG
GGCCGGGACCT -> GCCGGGACCTG
GGCCGTAGGCC -> GCCGTAGGCCC
GGCCGTATCGG -> GCCGTATCGGT
GGCGATCAACG -> GCGATCAACGC
GGCGCCTTAGG -> GCGCCTTAGGG
GGCGCTCTTTA -> GCGCTCTTTAG
GGCGGTCCGCG -> GCGGTCCGCGA
GGCGTCGGAGG -> GCGTCGGAGGA
GGCGTTGGCGC -> GCGTTGGCGCC
GGCGTTTCATT -> GCGTTTCATTG
GGCTACGGCGT -> GCTACGGCGTC
GGCTAGCTATG -> GCTAGCTATGT
GGCTAGCTTCT -> GCTAGCTTCTC
GGCTGCACCGT -> GCTGCACCGTC
GGCTTCCAGGT -> GCTTCCAGGTG
GGCTTTATCAT -> GCTTTATCATT
GGGAAAACTGG -> GGAAAACTGGG
GGGACATCCCT -> GGACATCCCTT
GGGACCGATAT -> GGACCGATATC
GGGACCTGTCA -> GGACCTGTCAT
GGGACGTCTGA -> GGACGTCTGAT
GGGAGAATAGG -> GGAGAATAGGG
GGGAGACGGAA -> GGAGACGGAAG
GGGAGGACTCA -> GGAGGACTCAT
GGGAGGCAGGT -> GGAGGCAGGTG
GGGAGTTACAT -> GGAGTTACATA
GGGATATCTGG -> GGATATCTGGA
GGGATCATCGG -> GGATCATCGGG
GGGATGCTGCA -> GGATGCTGCAT
GGGATTTCGGG -> GGATTTCGGGA
GGGCAATATAC -> GGCAATATACT
GGGCACTTGCG -> GGCACTTGCGA
GGGCCATACGC -> GGCCATACGCG
GGGCCATGCTC -> GGCCATGCTCC
GGGCCGGCAAG -> GGCCGGCAAGC
GGGCCGGCCCT -> GGCCGGCCCTA
GGGCCGTAGGC -> GGCCGTAGGCC
GGGCGGTCCGC -> GGCGGTCCGCG
GGGCGTTGGCG -> GGCGTTGGCGC
GGGGAAAACTG -> GGGAAAACTGG
GGGGACCGATA -> GGGACCGATAT
GGGGACGTCTG -> GGGACGTCTGA
GGGGAGGCAGG -> GGGAGGCAGGT
GGGGCCATGCT -> GGGCCATGCTC
GGGGCGTTGGC -> GGGCGTTGGCG
GGGGGAAAACT -> GGGGAAAACTG
GGGGGGAAAAC -> GGGGGAAAACT
GGGGGTTGGAT -> GGGGTTGGATG
GGGGTCACCGG -> GGGTCACCGGA
GGGGTTGGATG -> GGGTTGGATGA
GGGTACGCCGG -> GGTACGCCGGT
GGGTCACCGGA -> GGTCACCGGAT
GGGTCTACACG -> GGTCTACACGC
GGGTGTTATTT -> GGTGTTATTTC
GGGTTGGATGA -> GGTTGGATGAA
GGTAAAAGCAC -> GTAAAAGCACG
GGTACGCCGGT -> GTACGCCGGTT
GGTACGTATCA -> GTACGTATCAA
GGTAGAGTGCC -> GTAGAGTGCCT
GGTAGATTGTT -> GTAGATTGTTA
GGTAGCGAAGC -> GTAGCGAAGCA
GGTAGGCCAAT -> GTAGGCCAATC
GGTATGGACTG -> GTATGGACTGA
GGTATTTTTCT -> GTATTTTTCTA
GGTCACCGGAT -> GTCACCGGATA
GGTCAGTTGGC -> GTCAGTTGGCT
GGTCCGATATG -> GTCCGATATGA
GGTCCGCGACT -> GTCCGCGACTT
GGTCCTATTAT -> GTCCTATTATT
GGTCCTTCACT -> GTCCTTCACTT
GGTCGTTTATA -> GTCGTTTATAT
GGTCTACACGC -> GTCTACACGCA
GGTGAACTGTC -> GTGAACTGTCA
GGTGAGCGTTC -> GTGAGCGTTCA
GGTGCCACGTA -> GTGCCACGTAA
GGTGCCGTTTT -> GTGCCGTTTTT
GGTGTAGGTAG -> GTGTAGGTAGA
GGTGTTATTTC -> GTGTTATTTCC
GGTTAAGATTG -> GTTAAGATTGA,GTTAAGATTGC
GGTTACTCAAG -> GTTACTCAAGC
GGTTAGTCATG -> GTTAGTCATGG
GGTTCAATGGC -> GTTCAATGGCC
GGTTCCGTAGA -> GTTCCGTAGAC
GGTTGGATGAA -> GTTGGATGAAT
GGTTTAGCTTT -> GTTTAGCTTTC
GGTTTGAAAGA -> GTTTGAAAGAC
GTAAAAGCACG -> TAAAAGCACGA
GTAACTACATA -> TAACTACATAA
GTAACTCCTAG -> TAACTCCTAGG
GTACCAGAGTG -> TACCAGAGTGT
GTACGCCGGTT -> TACGCCGGTTA
GTACGGTCAGT -> TACGGTCAGTT
GTACGTATCAA -> TACGTATCAAG
GTACTGGGAGA -> TACTGGGAGAA
GTAGACGGTAG -> TAGACGGTAGA
GTAGAGTGCCT -> TAGAGTGCCTG
GTAGATGGTAG -> TAGATGGTAGG
GTAGATTGTTA -> TAGATTGTTAA
GTAGCGAAGCA -> TAGCGAAGCAA
GTAGGCCAATC -> TAGGCCAATCG
GTAGGCCCATT -> TAGGCCCATTG
GTAGGTAGATT -> TAGGTAGATTG
GTAGGTGCCAC -> TAGGTGCCACG
GTAGGTTTGAA -> TAGGTTTGAAA
GTAGTGTCACG -> TAGTGTCACGC
GTATCAAGAGA -> TATCAAGAGAC
GTATCGGAGTA -> TATCGGAGTAT
GTATCGGTTAG -> TATCGGTTAGT
GTATGCATACA -> TATGCATACAG
GTATGGACTGA -> TATGGACTGAA
GTATTTATGAC -> TATTTATGACG
GTATTTTTCTA -> TATTTTTCTAA
GTCACACTTGA -> TCACACTTGAG
GTCACCGGATA -> TCACCGGATAT
GTCACGCTACT -> TCACGCTACTA
GTCAGGGCCGG -> TCAGGGCCGGC
GTCAGTGCTGG -> TCAGTGCTGGG
GTCAGTTGGCT -> TCAGTTGGCTA
GTCATAGTTTC -> TCATAGTTTCA
GTCATGGGATG -> TCATGGGATGC
GTCCCAGGGCA -> TCCCAGGGCAA
GTCCGACGCTA -> TCCGACGCTAT
GTCCGATATGA -> TCCGATATGAT
GTCCGCGACTT -> TCCGCGACTTG
GTCCTATTATT -> TCCTATTATTA
GTCCTTCACTT -> TCCTTCACTTT
GTCGGAGGACA -> TCGGAGGACAA
GTCGGTACGTA -> TCGGTACGTAT
GTCGTTTATAT -> TCGTTTATATG
GTCTAATAGGA -> TCTAATAGGAG
GTCTACACGCA -> TCTACACGCAA
GTCTAGTGTGC -> TCTAGTGTGCG
GTCTCCGGACA -> TCTCCGGACAT
GTCTGAAGGCT -> TCTGAAGGCTG
GTCTGATCCTC -> TCTGATCCTCT
GTCTGCATACA -> TCTGCATACAT
GTCTGGGGGTT -> TCTGGGGGTTG
GTCTGTCTGAA -> TCTGTCTGAAG
GTGAACTGTCA -> TGAACTGTCAC
GTGACAGTTCA -> TGACAGTTCAC
GTGACCGTACG -> TGACCGTACGG
GTGACTCTTAA -> TGACTCTTAAT
GTGAGCGTTCA -> TGAGCGTTCAT
GTGATACTACT -> TGATACTACTA
GTGATGAGGCG -> TGATGAGGCGT
GTGCCACGTAA -> TGCCACGTAAC
GTGCCATTTCC -> TGCCATTTCCG
GTGCCGTTTTT -> TGCCGTTTTTC
GTGCCTGGCCG -> TGCCTGGCCGG
GTGCGCTGTCT -> TGCGCTGTCTC
GTGCTAAGCAC -> TGCTAAGCACT
GTGCTGACTGA -> TGCTGACTGAA
GTGCTGGGCCG -> TGCTGGGCCGG
GTGGTTTAGCT -> TGGTTTAGCTT
GTGTAGGTAGA -> TGTAGGTAGAT
GTGTCACGCTA -> TGTCACGCTAC
GTGTCAGGGCC -> TGTCAGGGCCG
GTGTGCGCTGT -> TGTGCGCTGTC
GTGTGGTTTAG -> TGTGGTTTAGC
GTGTTAACGCG -> TGTTAACGCGT
GTGTTACGTTG -> TGTTACGTTGT
GTGTTATTTCC -> TGTTATTTCCG
GTGTTGATTAG -> TGTTGATTAGC
GTGTTTGGATG -> TGTTTGGATGC
GTTAACACAAA -> TTAACACAAAA
GTTAACGCGTT -> TTAACGCGTTC
GTTAACTATAG -> TTAACTATAGG
GTTAAGATTGA -> TTAAGATTGAA
GTTAAGATTGC -> TTAAGATTGCA
GTTACAAACCA -> TTACAAACCAC
GTTACATAGGC -> TTACATAGGCG
GTTACGTTGTC -> TTACGTTGTCT
GTTACTCAAGC -> TTACTCAAGCG
GTTAGTCATGG -> TTAGTCATGGG
GTTATTGGTCC -> TTATTGGTCCG
GTTATTTCCGA -> TTATTTCCGAT
GTTCAACCAAT -> TTCAACCAATA
GTTCAATGGCC -> TTCAATGGCCC
GTTCACACAAG -> TTCACACAAGT
GTTCATCTTAC -> TTCATCTTACA
GTTCCAACAAA -> TTCCAACAAAA
GTTCCATGAGG -> TTCCATGAGGC
GTTCCGAGTCC -> TTCCGAGTCCG
GTTCCGTAGAC -> TTCCGTAGACG
GTTCTCTGAAG -> TTCTCTGAAGC
GTTCTGATAGT -> TTCTGATAGTA
GTTGAATACAA -> TTGAATACAAC
GTTGATATTTA -> TTGATATTTAG
GTTGATTAGCA -> TTGATTAGCAA
GTTGGATGAAT -> TTGGATGAATG
GTTGGCGCCTT -> TTGGCGCCTTA
GTTGGCGCTCT -> TTGGCGCTCTT
GTTGGCTAGCT -> TTGGCTAGCTA
GTTGTCTGTCT -> TTGTCTGTCTG
GTTTAAGCGTG -> TTTAAGCGTGA
GTTTAAGCTAC -> TTTAAGCTACA
GTTTAGCTTTC -> TTTAGCTTTCG
GTTTATATGAG -> TTTATATGAGA
GTTTCACGATC -> TTTCACGATCC
GTTTCATGCCC -> TTTCATGCCCC
GTTTCATTGGC -> TTTCATTGGCT
GTTTCCCGGGG -> TTTCCCGGGGG
GTTTCTATCAC -> TTTCTATCACG
GTTTGAAAGAC -> TTTGAAAGACG
GTTTGCCCGGT -> TTTGCCCGGTC
GTTTGGATGCT -> TTTGGATGCTA
GTTTGTCTAGT -> TTTGTCTAGTG
GTTTTTCTCAT -> TTTTTCTCATG
TAAAAGCACGA -> AAAAGCACGAT
TAAAGATCTGG -> AAAGATCTGGT
TAAATAAGAGC -> AAATAAGAGCG
TAAATTGATAT -> AAATTGATATT
TAACACAAAAA -> AACACAAAAAT
TAACCGAGATG -> AACCGAGATGA
TAACGCGTTCC -> AACGCGTTCCA
TAACTACATAA -> AACTACATAAG
TAACTATAGGG -> AACTATAGGGA
TAACTCACCTT -> AACTCACCTTA
TAACTCCTAGG -> AACTCCTAGGA
TAAGAGCGTTA -> AAGAGCGTTAC
TAAGATTGAAC -> AAGATTGAACA
TAAGATTGCAA -> AAGATTGCAAA
TAAGCACTTAG -> AAGCACTTAGC
TAAGCCTGCAC -> AAGCCTGCACG
TAAGCGTGATG -> AAGCGTGATGA
TAAGCTACATG -> AAGCTACATGA
TAAGGTTCCGT -> AAGGTTCCGTA
TAATAGGAGTT -> AATAGGAGTTT
TAATGCGCCTA -> AATGCGCCTAT
TAATGGCAAAG -> AATGGCAAAGA
TAATGGTATGG -> AATGGTATGGA
TAATGTTTCTA -> AATGTTTCTAT
TAATTCATCCA -> AATTCATCCAC
TAATTTGGGCG -> AATTTGGGCGG
TACAAACCACG -> ACAAACCACGC
TACAACGCTAG -> ACAACGCTAGG
TACAATTAATT -> ACAATTAATTT
TACACCAGCGT -> ACACCAGCGTT
TACACGCAAGG -> ACACGCAAGGA
TACATAAGCCT -> ACATAAGCCTG
TACATAGGCGA -> ACATAGGCGAT
TACATCGTTCC -> ACATCGTTCCG
TACATGAGGGC -> ACATGAGGGCC
TACCAAGCGTA -> ACCAAGCGTAG
TACCAGAGTGT -> ACCAGAGTGTT
TACCATTGCAC -> ACCATTGCACC
TACCGTGTGGT -> ACCGTGTGGTT
TACCTCGGGTA -> ACCTCGGGTAC
TACGCCGGTTA -> ACGCCGGTTAA
TACGCGACGAG -> ACGCGACGAGG
TACGGCGTCGG -> ACGGCGTCGGA
TACGGGCACTT -> ACGGGCACTTG
TACGGGGACGT -> ACGGGGACGTC
TACGGTCAGTT -> ACGGTCAGTTG
TACGGTTCAAT -> ACGGTTCAATG
TACGTATCAAG -> ACGTATCAAGA
TACGTTGTCTG -> ACGTTGTCTGT
TACTACTATTG -> ACTACTATTGG
TACTAGCCGAA -> ACTAGCCGAAG
TACTATAACTC -> ACTATAACTCA
TACTATAGCTT -> ACTATAGCTTT
TACTATTGGAT -> ACTATTGGATA
TACTCAAGCGT -> ACTCAAGCGTT
TACTGGGAGAA -> ACTGGGAGAAT
TACTTTGTGAT -> ACTTTGTGATA
TAGACGAATTT -> AGACGAATTTT
TAGACGGTAGA -> AGACGGTAGAG
TAGAGTGCCTG -> AGAGTGCCTGG
TAGATGGTAGG -> AGATGGTAGGC
TAGATTGTTAA -> AGATTGTTAAC
TAGCAAAATTT -> AGCAAAATTTC
TAGCAGCCCTT -> AGCAGCCCTTT
TAGCCAAAGAC -> AGCCAAAGACG
TAGCCATTAAT -> AGCCATTAATG
TAGCCGAACTA -> AGCCGAACTAA
TAGCCGAAGTG -> AGCCGAAGTGA
TAGCCTCTAAT -> AGCCTCTAATG
TAGCGAAGCAA -> AGCGAAGCAAA
TAGCGACGAGT -> AGCGACGAGTT
TAGCGAGGATG -> AGCGAGGATGG
TAGCTATGTTT -> AGCTATGTTTA
TAGCTTCTCCG -> AGCTTCTCCGA
TAGCTTTAGCC -> AGCTTTAGCCG
TAGCTTTCGCC -> AGCTTTCGCCT
TAGGAGTTTAA -> AGGAGTTTAAG
TAGGAGTTTCC -> AGGAGTTTCCC
TAGGCAATCGA -> AGGCAATCGAT
TAGGCACCCAT -> AGGCACCCATT
TAGGCCAATCG -> AGGCCAATCGG
TAGGCCCATTG -> AGGCCCATTGG
TAGGCGATCAA -> AGGCGATCAAC
TAGGGAGACGG -> AGGGAGACGGA
TAGGGCCGTAG -> AGGGCCGTAGG
TAGGGGAGGCA -> AGGGGAGGCAG
TAGGGTGTTAT -> AGGGTGTTATT
TAGGTAGATTG -> AGGTAGATTGT
TAGGTGAGCGT -> AGGTGAGCGTT
TAGGTGCCACG -> AGGTGCCACGT
TAGGTTTGAAA -> AGGTTTGAAAG
TAGTACCAGAG -> AGTACCAGAGT
TAGTAGGTGCC -> AGTAGGTGCCA
TAGTATCGGAG -> AGTATCGGAGT
TAGTCATGGGA -> AGTCATGGGAT
TAGTGTCACGC -> AGTGTCACGCT
TAGTGTGCGCT -> AGTGTGCGCTG
TAGTTCCATGA -> AGTTCCATGAG
TAGTTTCATGC -> AGTTTCATGCC
TATAAATTGAT -> ATAAATTGATA
TATAACTCACC -> ATAACTCACCT
TATACTATAAC -> ATACTATAACT
TATAGCTTTAG -> ATAGCTTTAGC
TATAGGGAGAC -> ATAGGGAGACG
TATAGTAGGTG -> ATAGTAGGTGC
TATATGAGACA -> ATATGAGACAA
TATCAAGAGAC -> ATCAAGAGACT
TATCACGGTCC -> ATCACGGTCCT
TATCAGGCCGG -> ATCAGGCCGGG
TATCATTATTC -> ATCATTATTCC
TATCGGAGTAT -> ATCGGAGTATT
TATCGGTTAGT -> ATCGGTTAGTC
TATCTGGAAAT -> ATCTGGAAATT
TATGACCCGCC -> ATGACCCGCCG
TATGACGTGTC -> ATGACGTGTCA
TATGAGACAAA -> ATGAGACAAAT
TATGATGGCTT -> ATGATGGCTTT
TATGCATACAG -> ATGCATACAGC
TATGGACTGAA -> ATGGACTGAAA
TATGTAGTGTC -> ATGTAGTGTCA
TATGTGTTAAC -> ATGTGTTAACG
TATGTTTAAGC -> ATGTTTAAGCG
TATTACGGGGA -> ATTACGGGGAC
TATTATTACGG -> ATTATTACGGG
TATTCAGAAGA -> ATTCAGAAGAT
TATTCCTCCCT -> ATTCCTCCCTT
TATTGGATATG -> ATTGGATATGT
TATTGGTCCGA -> ATTGGTCCGAT
TATTTACGGTT -> ATTTACGGTTC
TATTTAGGGTG -> ATTTAGGGTGT
TATTTAGTTCC -> ATTTAGTTCCA
TATTTATGACG -> ATTTATGACGT
TATTTCCGATA -> ATTTCCGATAG
TATTTTTCTAA -> ATTTTTCTAAC
TCAAACACCTC -> CAAACACCTCG
TCAACCAATAA -> CAACCAATAAT
TCAACCAATGT -> CAACCAATGTG
TCAACGCTAGA -> CAACGCTAGAC
TCAACTTGGGG -> CAACTTGGGGC
TCAAGAGACTT -> CAAGAGACTTC
TCAAGCGTTCT -> CAAGCGTTCTG
TCAATGCAGAG -> CAATGCAGAGA
TCAATGGCCCT -> CAATGGCCCTC
TCACACAAGTT -> CACACAAGTTG
TCACACTTGAG -> CACACTTGAGT
TCACCGGATAT -> CACCGGATATG
TCACCTTACCG -> CACCTTACCGT
TCACGATCCTG -> CACGATCCTGG
TCACGCTACTA -> CACGCTACTAG
TCACGGTCCTT -> CACGGTCCTTC
TCACTTTTTAC -> CACTTTTTACC
TCAGAAGATGC -> CAGAAGATGCT
TCAGGCCGGGA -> CAGGCCGGGAC
TCAGGGCCGGC -> CAGGGCCGGCC
TCAGTCTAATA -> CAGTCTAATAG
TCAGTGCTGGG -> CAGTGCTGGGC
TCAGTTGGCTA -> CAGTTGGCTAG
TCATAGTTTCA -> CATAGTTTCAT
TCATCCACGGG -> CATCCACGGGA
TCATCGGGGTC -> CATCGGGGTCA
TCATCTTACAC -> CATCTTACACC
TCATGAGTAGA -> CATGAGTAGAT
TCATGCCCCCG -> CATGCCCCCGG
TCATGGGATGC -> CATGGGATGCT
TCATGGTTAAG -> CATGGTTAAGA
TCATTATTCCT -> CATTATTCCTC
TCATTGGCTAC -> CATTGGCTACG
TCCAACAAAAG -> CCAACAAAAGG
TCCACGGGATC -> CCACGGGATCA
TCCAGAGGGGA -> CCAGAGGGGAC
TCCAGGTGTAG -> CCAGGTGTAGG
TCCATGAGGCA -> CCATGAGGCAC
TCCCACTCGAT -> CCCACTCGATT
TCCCAGGGCAA -> CCCAGGGCAAT
TCCCATATAGT -> CCCATATAGTA
TCCCGGGGGGA -> CCCGGGGGGAA
TCCCTTACCTC -> CCCTTACCTCG
TCCCTTATTCA -> CCCTTATTCAG
TCCGAAACAAT -> CCGAAACAATT
TCCGACGCTAT -> CCGACGCTATT
TCCGAGTCCGA -> CCGAGTCCGAC
TCCGATAGGCA -> CCGATAGGCAA
TCCGATATGAT -> CCGATATGATG
TCCGATTGCTG -> CCGATTGCTGT
TCCGCGACTTG -> CCGCGACTTGC
TCCGGACATAG -> CCGGACATAGC
TCCGGTCGTTT -> CCGGTCGTTTA
TCCGTAGACGG -> CCGTAGACGGT
TCCTACTATAG -> CCTACTATAGC
TCCTAGGAGTT -> CCTAGGAGTTT
TCCTATTATTA -> CCTATTATTAC
TCCTCAGTCTA -> CCTCAGTCTAA
TCCTCCCTTAC -> CCTCCCTTACC
TCCTCGCAGTC -> CCTCGCAGTCT
TCCTCTGTGTT -> CCTCTGTGTTT
TCCTGGAGATT -> CCTGGAGATTG
TCCTTCACTTT -> CCTTCACTTTT
TCGAGACGTTC -> CGAGACGTTCA
TCGATTGGGAT -> CGATTGGGATT
TCGATTTGTTA -> CGATTTGTTAA
TCGCAGTCTGC -> CGCAGTCTGCA
TCGCCGTGACT -> CGCCGTGACTC
TCGCCTATAAA -> CGCCTATAAAT
TCGCGCCAAGG -> CGCGCCAAGGT
TCGGAGGACAA -> CGGAGGACAAT
TCGGAGTATTT -> CGGAGTATTTA
TCGGGACATCC -> CGGGACATCCC
TCGGGAGGACT -> CGGGAGGACTC
TCGGGAGTTAC -> CGGGAGTTACA
TCGGGGTCACC -> CGGGGTCACCG
TCGGGTACGCC -> CGGGTACGCCG
TCGGTACGTAT -> CGGTACGTATC
TCGGTGCCGTT -> CGGTGCCGTTT
TCGGTTAGTCA -> CGGTTAGTCAT
TCGTGCCATTT -> CGTGCCATTTC
TCGTTCCGAGT -> CGTTCCGAGTC
TCGTTTATATG -> CGTTTATATGA
TCGTTTGTCTA -> CGTTTGTCTAG
TCTAACCGAGA -> CTAACCGAGAT
TCTAATAGGAG -> CTAATAGGAGT
TCTAATGGTAT -> CTAATGGTATG
TCTACACGCAA -> CTACACGCAAG
TCTAGTGTGCG -> CTAGTGTGCGC
TCTATCACGGT -> CTATCACGGTC
TCTCATGAGTA -> CTCATGAGTAG
TCTCCGATTGC -> CTCCGATTGCT
TCTCCGGACAT -> CTCCGGACATA
TCTCGCGCCAA -> CTCGCGCCAAG
TCTCTGAAGCG -> CTCTGAAGCGG
TCTGAAGCGGC -> CTGAAGCGGCA
TCTGAAGGCTG -> CTGAAGGCTGC
TCTGATAGTAC -> CTGATAGTACC
TCTGATCCTCT -> CTGATCCTCTG
TCTGCATACAT -> CTGCATACATC
TCTGCGTGTTA -> CTGCGTGTTAC
TCTGGAAATTA -> CTGGAAATTAG
TCTGGGGGTTG -> CTGGGGGTTGG
TCTGGTTACTC -> CTGGTTACTCA
TCTGTAACTCC -> CTGTAACTCCT
TCTGTCTGAAG -> CTGTCTGAAGG
TCTGTGTTTGG -> CTGTGTTTGGA
TCTGTTTCACG -> CTGTTTCACGA
TCTTAATGCGC -> CTTAATGCGCC
TCTTACACCAG -> CTTACACCAGC
TCTTCGGGAGT -> CTTCGGGAGTT
TCTTTAGCCTC -> CTTTAGCCTCT
TGAAACCCCGA -> GAAACCCCGAG
TGAAACTTTCG -> GAAACTTTCGC
TGAAAGACGAG -> GAAAGACGAGC
TGAAATACAAT -> GAAATACAATT
TGAACAGGCCG -> GAACAGGCCGT
TGAACTGTCAC -> GAACTGTCACA
TGAAGCGGCAT -> GAAGCGGCATC
TGAAGGCTGCA -> GAAGGCTGCAC
TGAATACAACG -> GAATACAACGC
TGAATGCGCGA -> GAATGCGCGAT
TGACAGTTCAC -> GACAGTTCACA
TGACCCGCCGC -> GACCCGCCGCT
TGACCGTACGG -> GACCGTACGGT
TGACGTGTCAG -> GACGTGTCAGG
TGACTCTTAAT -> GACTCTTAATG
TGACTGAAATA -> GACTGAAATAC
TGAGACAAATA -> GAGACAAATAG
TGAGAGAAGTG -> GAGAGAAGTGC
TGAGCGTTCAT -> GAGCGTTCATC
TGAGGCACAAT -> GAGGCACAATC
TGAGGCGTTTC -> GAGGCGTTTCA
TGAGGCTTCCA -> GAGGCTTCCAG
TGAGGGCCATA -> GAGGGCCATAC
TGAGTAGATGG -> GAGTAGATGGT
TGAGTCCCAGG -> GAGTCCCAGGG
TGATACTACTA -> GATACTACTAT
TGATAGGTGAG -> GATAGGTGAGC
TGATAGTACCA -> GATAGTACCAG
TGATATTTAGG -> GATATTTAGGG
TGATATTTAGT -> GATATTTAGTT
TGATCCTCTGT -> GATCCTCTGTG
TGATGAGGCGT -> GATGAGGCGTT
TGATGGCTTTA -> GATGGCTTTAT
TGATTAGCAAA -> GATTAGCAAAA
TGATTGTATGC -> GATTGTATGCA
TGCAAACATAC -> GCAAACATACT
TGCACCCCTCC -> GCACCCCTCCC
TGCACCGTCTG -> GCACCGTCTGG
TGCACGGCTAG -> GCACGGCTAGC
TGCAGAGAGAA -> GCAGAGAGAAT
TGCATACATCG -> GCATACATCGT
TGCATCGTGCC -> GCATCGTGCCA
TGCCACGTAAC -> GCCACGTAACT
TGCCATTTCCG -> GCCATTTCCGG
TGCCCCCGGAT -> GCCCCCGGATT
TGCCCGGTCCT -> GCCCGGTCCTA
TGCCGTTGGCG -> GCCGTTGGCGC
TGCCGTTTTTC -> GCCGTTTTTCT
TGCCTGGCCGG -> GCCTGGCCGGA
TGCGAAATTCT -> GCGAAATTCTT
TGCGCATGTCA -> GCGCATGTCAG
TGCGCCTATGA -> GCGCCTATGAC
TGCGCGATCGA -> GCGCGATCGAG
TGCGCTGTCTC -> GCGCTGTCTCC
TGCGTGTTACG -> GCGTGTTACGT
TGCTAAGCACT -> GCTAAGCACTT
TGCTACGGGCA -> GCTACGGGCAC
TGCTCCAGAGG -> GCTCCAGAGGG
TGCTCCTCAGT -> GCTCCTCAGTC
TGCTGAAACCC -> GCTGAAACCCC
TGCTGACTGAA -> GCTGACTGAAA
TGCTGCATCGT -> GCTGCATCGTG
TGCTGGGCCGG -> GCTGGGCCGGC
TGCTGTTCTCT -> GCTGTTCTCTG
TGCTTAAATAA -> GCTTAAATAAG
TGGAAATTAGC -> GGAAATTAGCG
TGGACCCTGCT -> GGACCCTGCTC
TGGACTGAAAC -> GGACTGAAACT
TGGAGATTGCT -> GGAGATTGCTT
TGGATAAAGAT -> GGATAAAGATC
TGGATATGTAG -> GGATATGTAGT
TGGATGAATGC -> GGATGAATGCG
TGGATGCTACG -> GGATGCTACGG
TGGCAAAGACA -> GGCAAAGACAA
TGGCCCTCAAC -> GGCCCTCAACT
TGGCCGGACCC -> GGCCGGACCCA
TGGCGCCTTAG -> GGCGCCTTAGG
TGGCGCTCTTT -> GGCGCTCTTTA
TGGCTACGGCG -> GGCTACGGCGT
TGGCTAGCTAT -> GGCTAGCTATG
TGGCTTTATCA -> GGCTTTATCAT
TGGGAGAATAG -> GGGAGAATAGG
TGGGATGCTGC -> GGGATGCTGCA
TGGGATTTCGG -> GGGATTTCGGG
TGGGCCGGCAA -> GGGCCGGCAAG
TGGGCGGTCCG -> GGGCGGTCCGC
TGGGGCCATGC -> GGGGCCATGCT
TGGGGCGTTGG -> GGGGCGTTGGC
TGGGGGTTGGA -> GGGGGTTGGAT
TGGGTCTACAC -> GGGTCTACACG
TGGTAAAAGCA -> GGTAAAAGCAC
TGGTAGGCCAA -> GGTAGGCCAAT
TGGTATGGACT -> GGTATGGACTG
TGGTCCGATAT -> GGTCCGATATG
TGGTTAAGATT -> GGTTAAGATTG
TGGTTACTCAA -> GGTTACTCAAG
TGGTTTAGCTT -> GGTTTAGCTTT
TGTAACTCCTA -> GTAACTCCTAG
TGTAGGTAGAT -> GTAGGTAGATT
TGTAGTGTCAC -> GTAGTGTCACG
TGTATGCATAC -> GTATGCATACA
TGTCACACTTG -> GTCACACTTGA
TGTCACGCTAC -> GTCACGCTACT
TGTCAGGGCCG -> GTCAGGGCCGG
TGTCAGTGCTG -> GTCAGTGCTGG
TGTCATAGTTT -> GTCATAGTTTC
TGTCTAGTGTG -> GTCTAGTGTGC
TGTCTCCGGAC -> GTCTCCGGACA
TGTCTGAAGGC -> GTCTGAAGGCT
TGTCTGTCTGA -> GTCTGTCTGAA
TGTGACAGTTC -> GTGACAGTTCA
TGTGATACTAC -> GTGATACTACT
TGTGCGCTGTC -> GTGCGCTGTCT
TGTGGTTTAGC -> GTGGTTTAGCT
TGTGTTAACGC -> GTGTTAACGCG
TGTGTTTGGAT -> GTGTTTGGATG
TGTTAACACAA -> GTTAACACAAA
TGTTAACGCGT -> GTTAACGCGTT
TGTTAACTATA -> GTTAACTATAG
TGTTACGTTGT -> GTTACGTTGTC
TGTTATTTCCG -> GTTATTTCCGA
TGTTCTCTGAA -> GTTCTCTGAAG
TGTTGATTAGC -> GTTGATTAGCA
TGTTTAAGCGT -> GTTTAAGCGTG
TGTTTCACGAT -> GTTTCACGATC
TGTTTCTATCA -> GTTTCTATCAC
TGTTTGGATGC -> GTTTGGATGCT
TTAAATAAGAG -> TAAATAAGAGC
TTAACACAAAA -> TAACACAAAAA
TTAACGCGTTC -> TAACGCGTTCC
TTAACTATAGG -> TAACTATAGGG
TTAAGATTGAA -> TAAGATTGAAC
TTAAGATTGCA -> TAAGATTGCAA
TTAAGCGTGAT -> TAAGCGTGATG
TTAAGCTACAT -> TAAGCTACATG
TTAATGCGCCT -> TAATGCGCCTA
TTAATGGCAAA -> TAATGGCAAAG
TTAATTTGGGC -> TAATTTGGGCG
TTACAAACCAC -> TACAAACCACG
TTACACCAGCG -> TACACCAGCGT
TTACATAGGCG -> TACATAGGCGA
TTACCAAGCGT -> TACCAAGCGTA
TTACCATTGCA -> TACCATTGCAC
TTACCGTGTGG -> TACCGTGTGGT
TTACCTCGGGT -> TACCTCGGGTA
TTACGGGGACG -> TACGGGGACGT
TTACGGTTCAA -> TACGGTTCAAT
TTACGTTGTCT -> TACGTTGTCTG
TTACTCAAGCG -> TACTCAAGCGT
TTAGCAAAATT -> TAGCAAAATTT
TTAGCAGCCCT -> TAGCAGCCCTT
TTAGCCAAAGA -> TAGCCAAAGAC
TTAGCCGAACT -> TAGCCGAACTA
TTAGCCTCTAA -> TAGCCTCTAAT
TTAGCGAGGAT -> TAGCGAGGATG
TTAGCTTTCGC -> TAGCTTTCGCC
TTAGGGCCGTA -> TAGGGCCGTAG
TTAGGGTGTTA -> TAGGGTGTTAT
TTAGTCATGGG -> TAGTCATGGGA
TTAGTTCCATG -> TAGTTCCATGA
TTATATGAGAC -> TATATGAGACA
TTATCATTATT -> TATCATTATTC
TTATGACGTGT -> TATGACGTGTC
TTATTACGGGG -> TATTACGGGGA
TTATTCAGAAG -> TATTCAGAAGA
TTATTCCTCCC -> TATTCCTCCCT
TTATTGGTCCG -> TATTGGTCCGA
TTATTTCCGAT -> TATTTCCGATA
TTCAACCAATA -> TCAACCAATAA
TTCAATGCAGA -> TCAATGCAGAG
TTCAATGGCCC -> TCAATGGCCCT
TTCACACAAGT -> TCACACAAGTT
TTCACGATCCT -> TCACGATCCTG
TTCACTTTTTA -> TCACTTTTTAC
TTCAGAAGATG -> TCAGAAGATGC
TTCATCCACGG -> TCATCCACGGG
TTCATCTTACA -> TCATCTTACAC
TTCATGCCCCC -> TCATGCCCCCG
TTCATTGGCTA -> TCATTGGCTAC
TTCCAACAAAA -> TCCAACAAAAG
TTCCAGGTGTA -> TCCAGGTGTAG
TTCCATGAGGC -> TCCATGAGGCA
TTCCCGGGGGG -> TCCCGGGGGGA
TTCCGAAACAA -> TCCGAAACAAT
TTCCGAGTCCG -> TCCGAGTCCGA
TTCCGATAGGC -> TCCGATAGGCA
TTCCGGTCGTT -> TCCGGTCGTTT
TTCCGTAGACG -> TCCGTAGACGG
TTCCTACTATA -> TCCTACTATAG
TTCCTCCCTTA -> TCCTCCCTTAC
TTCCTCGCAGT -> TCCTCGCAGTC
TTCGCCGTGAC -> TCGCCGTGACT
TTCGCCTATAA -> TCGCCTATAAA
TTCGGGAGGAC -> TCGGGAGGACT
TTCGGGAGTTA -> TCGGGAGTTAC
TTCGGTGCCGT -> TCGGTGCCGTT
TTCTAACCGAG -> TCTAACCGAGA
TTCTATCACGG -> TCTATCACGGT
TTCTCATGAGT -> TCTCATGAGTA
TTCTCCGATTG -> TCTCCGATTGC
TTCTCTGAAGC -> TCTCTGAAGCG
TTCTGATAGTA -> TCTGATAGTAC
TTCTTCGGGAG -> TCTTCGGGAGT
TTGAAAGACGA -> TGAAAGACGAG
TTGAACAGGCC -> TGAACAGGCCG
TTGAATACAAC -> TGAATACAACG
TTGAGAGAAGT -> TGAGAGAAGTG
TTGAGTCCCAG -> TGAGTCCCAGG
TTGATATTTAG -> TGATATTTAGG,TGATATTTAGT
TTGATTAGCAA -> TGATTAGCAAA
TTGATTGTATG -> TGATTGTATGC
TTGCAAACATA -> TGCAAACATAC
TTGCACCCCTC -> TGCACCCCTCC
TTGCCCGGTCC -> TGCCCGGTCCT
TTGCCGTTGGC -> TGCCGTTGGCG
TTGCGAAATTC -> TGCGAAATTCT
TTGCGCATGTC -> TGCGCATGTCA
TTGCTGTTCTC -> TGCTGTTCTCT
TTGCTTAAATA -> TGCTTAAATAA
TTGGATAAAGA -> TGGATAAAGAT
TTGGATATGTA -> TGGATATGTAG
TTGGATGAATG -> TGGATGAATGC
TTGGATGCTAC -> TGGATGCTACG
TTGGCGCCTTA -> TGGCGCCTTAG
TTGGCGCTCTT -> TGGCGCTCTTT
TTGGCTACGGC -> TGGCTACGGCG
TTGGCTAGCTA -> TGGCTAGCTAT
TTGGGATTTCG -> TGGGATTTCGG
TTGGGCGGTCC -> TGGGCGGTCCG
TTGGGGCCATG -> TGGGGCCATGC
TTGGTCCGATA -> TGGTCCGATAT
TTGTATGCATA -> TGTATGCATAC
TTGTCTAGTGT -> TGTCTAGTGTG
TTGTCTGTCTG -> TGTCTGTCTGA
TTGTGATACTA -> TGTGATACTAC
TTGTTAACACA -> TGTTAACACAA
TTGTTAACTAT -> TGTTAACTATA
TTTAAGCGTGA -> TTAAGCGTGAT
TTTAAGCTACA -> TTAAGCTACAT
TTTACCATTGC -> TTACCATTGCA
TTTACGGTTCA -> TTACGGTTCAA
TTTAGCAGCCC -> TTAGCAGCCCT
TTTAGCCGAAC -> TTAGCCGAACT
TTTAGCCTCTA -> TTAGCCTCTAA
TTTAGCTTTCG -> TTAGCTTTCGC
TTTAGGGTGTT -> TTAGGGTGTTA
TTTAGTTCCAT -> TTAGTTCCATG
TTTATATGAGA -> TTATATGAGAC
TTTATCATTAT -> TTATCATTATT
TTTATGACGTG -> TTATGACGTGT
TTTCACGATCC -> TTCACGATCCT
TTTCATGCCCC -> TTCATGCCCCC
TTTCATTGGCT -> TTCATTGGCTA
TTTCCCGGGGG -> TTCCCGGGGGG
TTTCCGATAGG -> TTCCGATAGGC
TTTCCGGTCGT -> TTCCGGTCGTT
TTTCCTACTAT -> TTCCTACTATA
TTTCCTCGCAG -> TTCCTCGCAGT
TTTCGCCGTGA -> TTCGCCGTGAC
TTTCGCCTATA -> TTCGCCTATAA
TTTCGGGAGGA -> TTCGGGAGGAC
TTTCTAACCGA -> TTCTAACCGAG
TTTCTATCACG -> TTCTATCACGG
TTTCTCATGAG -> TTCTCATGAGT
TTTGAAAGACG -> TTGAAAGACGA
TTTGATTGTAT -> TTGATTGTATG
TTTGCCCGGTC -> TTGCCCGGTCC
TTTGGATGCTA -> TTGGATGCTAC
TTTGGGCGGTC -> TTGGGCGGTCC
TTTGTCTAGTG -> TTGTCTAGTGT
TTTGTGATACT -> TTGTGATACTA
TTTGTTAACTA -> TTGTTAACTAT
TTTTACCATTG -> TTTACCATTGC
TTTTAGCAGCC -> TTTAGCAGCCC
TTTTCTAACCG -> TTTCTAACCGA
TTTTCTCATGA -> TTTCTCATGAG
TTTTTACCATT -> TTTTACCATTG
TTTTTCTAACC -> TTTTCTAACCG
TTTTTCTCATG -> TTTTCTCATGA
