AAAAAAGGGCA -> AAAAAGGGCAC
AAAAAGGGCAC -> AAAAGGGCACT
AAAAGGGCACT -> AAAGGGCACTC
AAAATGATTGA -> AAATGATTGAG
AAACAACCTGT -> AACAACCTGTC
AAACTGGGTTA -> AACTGGGTTAT
AAACTTCTGGA -> AACTTCTGGAA
AAACTTGAGAT -> AACTTGAGATC
AAAGACTGGGC -> AAGACTGGGCT
AAAGCCCCCAA -> AAGCCCCCAAC
AAAGCGTCAGA -> AAGCGTCAGAG
AAAGCTGAGCT -> AAGCTGAGCTG
AAAGGCCCCTA -> AAGGCCCCTAA
AAAGGGAAGCT -> AAGGGAAGCTG
AAAGGGCACTC -> AAGGGCACTCG
AAATAAGCGAT -> AATAAGCGATG
AAATCACATTG -> AATCACATTGA
AAATCGTTTTG -> AATCGTTTTGG
AAATGATTGAG -> AATGATTGAGC
AAATTGTGGAA -> AATTGTGGAAG
AACAAATCACA -> ACAAATCACAT
AACAACCTGTC -> ACAACCTGTCC
AACAAGCCCGG -> ACAAGCCCGGA
AACAAGGGGCC -> ACAAGGGGCCT
AACAATGGTAG -> ACAATGGTAGA
AACACATGTAC -> ACACATGTACT
AACACCCCGCG -> ACACCCCGCGC
AACACTCATGA -> ACACTCATGAA
AACACTCTCGC -> ACACTCTCGCA
AACATGTTATT -> ACATGTTATTA
AACCAGGTCAC -> ACCAGGTCACT
AACCAGTGTTA -> ACCAGTGTTAT
AACCCCCGGGT -> ACCCCCGGGTA
AACCCGCGGAG -> ACCCGCGGAGT
AACCGCGTGAG -> ACCGCGTGAGA
AACCGGGCGGT -> ACCGGGCGGTA
AACCGGGCTTT -> ACCGGGCTTTG
AACCTACGGTA -> ACCTACGGTAT
AACCTGTCCCC -> ACCTGTCCCCG
AACCTTTAACG -> ACCTTTAACGC
AACGACACAAC -> ACGACACAACC
AACGACGTAGC -> ACGACGTAGCG
AACGAGTAAAC -> ACGAGTAAACA
AACGATGTTCA -> ACGATGTTCAT
AACGCGGAAGT -> ACGCGGAAGTC
AACGCTCATCT -> ACGCTCATCTT
AACGTCGCCGT -> ACGTCGCCGTG
AACGTCTAGGA -> ACGTCTAGGAA
AACGTGGTAAC -> ACGTGGTAACA
AACTCCCGTGT -> ACTCCCGTGTA
AACTCGAGACC -> ACTCGAGACCG
AACTCGAGTAG -> ACTCGAGTAGG
AACTGGCAACG -> ACTGGCAACGA
AACTGGGTTAT -> ACTGGGTTATC
AACTTCTGGAA -> ACTTCTGGAAT
AACTTGAGATC -> ACTTGAGATCC
AAGAACCGGGC -> AGAACCGGGCG
AAGACTAATCC -> AGACTAATCCA
AAGACTGGGCT -> AGACTGGGCTT
AAGAGACTTAA -> AGAGACTTAAT
AAGATCGTAAG -> AGATCGTAAGT
AAGATTCCAGA -> AGATTCCAGAA
AAGCAGTGCTC -> AGCAGTGCTCG
AAGCCCCCAAC -> AGCCCCCAACA
AAGCCCGGAGC -> AGCCCGGAGCA
AAGCCGATAAC -> AGCCGATAACA
AAGCCGGGTAC -> AGCCGGGTACT
AAGCCGTACAG -> AGCCGTACAGT
AAGCGATGATG -> AGCGATGATGT
AAGCGTCAGAG -> AGCGTCAGAGA
AAGCTGAGCTG -> AGCTGAGCTGT
AAGCTGCAGAT -> AGCTGCAGATT
AAGGAATTTAG -> AGGAATTTAGG
AAGGACGGAAT -> AGGACGGAATT
AAGGAGTATTG -> AGGAGTATTGT
AAGGCATAGCT -> AGGCATAGCTG
AAGGCCCCTAA -> AGGCCCCTAAG
AAGGCTAGCAC -> AGGCTAGCACT
AAGGGAAGCTG -> AGGGAAGCTGC
AAGGGAGGCCT -> AGGGAGGCCTG
AAGGGCACTCG -> AGGGCACTCGA
AAGGGGCCTTA -> AGGGGCCTTAA
AAGGGGTGGGC -> AGGGGTGGGCA
AAGTACGCCCC -> AGTACGCCCCT
AAGTCCTTGCT -> AGTCCTTGCTT
AAGTCGCTTGT -> AGTCGCTTGTC
AAGTCGGTCGA -> AGTCGGTCGAA
AAGTGGTATGC -> AGTGGTATGCA
AAGTTCATAGT -> AGTTCATAGTT
AAGTTTACACC -> AGTTTACACCG
AAGTTTGTGCT -> AGTTTGTGCTC
AATAAACTGGG -> ATAAACTGGGT
AATAAGCGATG -> ATAAGCGATGA
AATACACCGTC -> ATACACCGTCA
AATACGAAGGC -> ATACGAAGGCT
AATACTAGCGC -> ATACTAGCGCG
AATACTCAAAA -> ATACTCAAAAT
AATAGATAACT -> ATAGATAACTC
AATAGGACGCG -> ATAGGACGCGG
AATCAAAAAAG -> ATCAAAAAAGG
AATCACATTGA -> ATCACATTGAA
AATCAGATTTG -> ATCAGATTTGT
AATCCATAGTT -> ATCCATAGTTA
AATCGTTTTGG -> ATCGTTTTGGT
AATGAGCGGAG -> ATGAGCGGAGA
AATGAGTATCG -> ATGAGTATCGG
AATGATTGAGC -> ATGATTGAGCA
AATGCAGTTAA -> ATGCAGTTAAC
AATGCCGTCAG -> ATGCCGTCAGT
AATGCTCTGTA -> ATGCTCTGTAT
AATGGAGTATA -> ATGGAGTATAT
AATGGTAGAAG -> ATGGTAGAAGA
AATGTCCAAAG -> ATGTCCAAAGG
AATGTCCTCTA -> ATGTCCTCTAT
AATTAGTGTGA -> ATTAGTGTGAA
AATTCAACCAG -> ATTCAACCAGG
AATTGCCACCA -> ATTGCCACCAT
AATTGCTATAC -> ATTGCTATACG
AATTGTGGAAG -> ATTGTGGAAGG
AATTTAGGAGG -> ATTTAGGAGGT
ACAAAGGGAAG -> CAAAGGGAAGC
ACAAATCACAT -> CAAATCACATT
ACAACCTGTCC -> CAACCTGTCCC
ACAACCTTTAA -> CAACCTTTAAC
ACAACGACACA -> CAACGACACAA
ACAACGTCGCC -> CAACGTCGCCG
ACAACTGGCAA -> CAACTGGCAAC
ACAAGCCCGGA -> CAAGCCCGGAG
ACAAGGGGCCT -> CAAGGGGCCTT
ACAATACTCAA -> CAATACTCAAA
ACAATGCCGTC -> CAATGCCGTCA
ACAATGGTAGA -> CAATGGTAGAA
ACACAACCTTT -> CACAACCTTTA
ACACAGCACGC -> CACAGCACGCG
ACACAGCTGTT -> CACAGCTGTTC
ACACAGTCCGT -> CACAGTCCGTG
ACACATGTACT -> CACATGTACTG
ACACATTCATC -> CACATTCATCC
ACACCCCGCGC -> CACCCCGCGCA
ACACCGCATAA -> CACCGCATAAC
ACACCGTCATA -> CACCGTCATAT
ACACTCATGAA -> CACTCATGAAA
ACACTCTCGCA -> CACTCTCGCAC
ACAGCACGCGT -> CAGCACGCGTA
ACAGCCCAGGT -> CAGCCCAGGTA
ACAGCTGTTCA -> CAGCTGTTCAC
ACAGTCCGGTT -> CAGTCCGGTTC
ACAGTCCGTGA -> CAGTCCGTGAT
ACAGTGATTTC -> CAGTGATTTCA
ACATACCAGAG -> CATACCAGAGC
ACATGTAACAA -> CATGTAACAAA
ACATGTACTGC -> CATGTACTGCA
ACATGTTATTA -> CATGTTATTAT
ACATTAAATCG -> CATTAAATCGT
ACATTCATCCA -> CATTCATCCAG
ACATTGAATAC -> CATTGAATACT
ACCAACCCGCG -> CCAACCCGCGG
ACCAGAGCCTG -> CCAGAGCCTGA
ACCAGGTCACT -> CCAGGTCACTA
ACCAGTGGGGG -> CCAGTGGGGGA
ACCAGTGTTAT -> CCAGTGTTATC
ACCCCCGGGTA -> CCCCCGGGTAT
ACCCCGCGCAG -> CCCCGCGCAGA
ACCCGCGGAGT -> CCCGCGGAGTT
ACCCGTACGGA -> CCCGTACGGAT
ACCCGTAGGAA -> CCCGTAGGAAC
ACCGACCTCAG -> CCGACCTCAGT
ACCGAGTTGCT -> CCGAGTTGCTG
ACCGATTCACA -> CCGATTCACAG
ACCGCATAACG -> CCGCATAACGC
ACCGCGTGAGA -> CCGCGTGAGAG
ACCGGATAATA -> CCGGATAATAA
ACCGGGCGGTA -> CCGGGCGGTAG
ACCGGGCTTTG -> CCGGGCTTTGT
ACCGTCATATA -> CCGTCATATAC
ACCGTGACCGA -> CCGTGACCGAG
ACCGTGATTTT -> CCGTGATTTTT
ACCTACGGTAT -> CCTACGGTATA
ACCTCAGTGCC -> CCTCAGTGCCG
ACCTGTCCCCG -> CCTGTCCCCGA
ACCTTTAACGC -> CCTTTAACGCT
ACCTTTACTTG -> CCTTTACTTGA
ACGAAGGCTAG -> CGAAGGCTAGC
ACGACACAACC -> CGACACAACCT
ACGACGTAGCG -> CGACGTAGCGC
ACGAGTAAACA -> CGAGTAAACAA
ACGATACAACG -> CGATACAACGT
ACGATGTTCAT -> CGATGTTCATG
ACGCACAAAGG -> CGCACAAAGGG
ACGCCCCTAGC -> CGCCCCTAGCA
ACGCCGTAGTT -> CGCCGTAGTTA
ACGCGGAAGTC -> CGCGGAAGTCC
ACGCGGTACAA -> CGCGGTACAAT
ACGCGTATCGC -> CGCGTATCGCA
ACGCTAAGTTT -> CGCTAAGTTTG
ACGCTCATCTT -> CGCTCATCTTC
ACGGAATTGCT -> CGGAATTGCTA
ACGGATCCCCG -> CGGATCCCCGA
ACGGGGTCTCC -> CGGGGTCTCCC
ACGGTATAGTA -> CGGTATAGTAT
ACGGTCTGAAA -> CGGTCTGAAAC
ACGTAGCGCCT -> CGTAGCGCCTT
ACGTCGCCGTG -> CGTCGCCGTGT
ACGTCTAGGAA -> CGTCTAGGAAC
ACGTGGTAACA -> CGTGGTAACAA
ACGTTGGCTCT -> CGTTGGCTCTT
ACGTTTATGAG -> CGTTTATGAGC
ACTAATCCATA -> CTAATCCATAG
ACTAGACCTTT -> CTAGACCTTTA
ACTAGCGCGCA -> CTAGCGCGCAC
ACTATATGCAC -> CTATATGCACT
ACTATTTGGCT -> CTATTTGGCTC
ACTCAAAATGA -> CTCAAAATGAT
ACTCAGATCTG -> CTCAGATCTGC
ACTCATGAAAC -> CTCATGAAACT
ACTCCCGTGTA -> CTCCCGTGTAC
ACTCCTATTAG -> CTCCTATTAGG
ACTCCTGTTGT -> CTCCTGTTGTA
ACTCGAATAGG -> CTCGAATAGGA
ACTCGAGACCG -> CTCGAGACCGT
ACTCGAGTAGG -> CTCGAGTAGGG
ACTCTCGCACC -> CTCTCGCACCA
ACTGCACCGGA -> CTGCACCGGAT
ACTGCAGAGGT -> CTGCAGAGGTA
ACTGCAGTGTG -> CTGCAGTGTGG
ACTGGCAACGA -> CTGGCAACGAC
ACTGGGCTGCA -> CTGGGCTGCAG
ACTGGGCTTAC -> CTGGGCTTACG
ACTGGGTTATC -> CTGGGTTATCA
ACTGGGTTTCG -> CTGGGTTTCGA
ACTGTGAAGTT -> CTGTGAAGTTC
ACTTAACCCCC -> CTTAACCCCCG
ACTTAACCTAC -> CTTAACCTACG
ACTTAATAGAT -> CTTAATAGATA
ACTTAATTCAA -> CTTAATTCAAC
ACTTACGGGGT -> CTTACGGGGTC
ACTTAGGTTTT -> CTTAGGTTTTG
ACTTCTGGAAT -> CTTCTGGAATG
ACTTGAGATCC -> CTTGAGATCCT
ACTTGAGCGTC -> CTTGAGCGTCG
AGAACAATGGT -> GAACAATGGTA
AGAACCGGGCG -> GAACCGGGCGG
AGAAGACTAAT -> GAAGACTAATC
AGAATCAGATT -> GAATCAGATTT
AGACAACGACA -> GACAACGACAC
AGACCCGTACG -> GACCCGTACGG
AGACCGTGATT -> GACCGTGATTT
AGACCTTTACT -> GACCTTTACTT
AGACTAATCCA -> GACTAATCCAT
AGACTCAGATC -> GACTCAGATCT
AGACTCCTATT -> GACTCCTATTA
AGACTGGGCTT -> GACTGGGCTTA
AGACTTAATTC -> GACTTAATTCA
AGAGACAACGA -> GAGACAACGAC
AGAGACTTAAT -> GAGACTTAATT
AGAGATGCGCG -> GAGATGCGCGC
AGAGCCTGACT -> GAGCCTGACTT
AGAGGAGTACT -> GAGGAGTACTC
AGAGGTAAGGG -> GAGGTAAGGGG
AGATAACTCGA -> GATAACTCGAG
AGATAGCATCT -> GATAGCATCTA
AGATCAGACTC -> GATCAGACTCA
AGATCCGCCTG -> GATCCGCCTGG
AGATCCTGAAC -> GATCCTGAACC
AGATCGTAAGT -> GATCGTAAGTT
AGATCTGCGCC -> GATCTGCGCCA
AGATGCGCGCC -> GATGCGCGCCT
AGATGTCTACC -> GATGTCTACCG
AGATGTGTGAC -> GATGTGTGACC
AGATTCCAGAA -> GATTCCAGAAT
AGATTGGCAAC -> GATTGGCAACA
AGATTTAACCA -> GATTTAACCAG
AGATTTGTGTA -> GATTTGTGTAA
AGCAAAGACTG -> GCAAAGACTGG
AGCAACGTGGT -> GCAACGTGGTA
AGCACATACCA -> GCACATACCAG
AGCACGCGTAT -> GCACGCGTATC
AGCACTATATG -> GCACTATATGC
AGCACTGCAGT -> GCACTGCAGTG
AGCAGTAAGTA -> GCAGTAAGTAC
AGCAGTGCTCG -> GCAGTGCTCGC
AGCATCTAGTG -> GCATCTAGTGT
AGCATGCAGCA -> GCATGCAGCAA
AGCATGCCTTG -> GCATGCCTTGG
AGCCAGACCCG -> GCCAGACCCGT
AGCCCAGGTAT -> GCCCAGGTATT
AGCCCCCAACA -> GCCCCCAACAC
AGCCCGCGATG -> GCCCGCGATGA
AGCCCGGAGCA -> GCCCGGAGCAG
AGCCGATAACA -> GCCGATAACAC
AGCCGGGTACT -> GCCGGGTACTT
AGCCGTACAGT -> GCCGTACAGTC
AGCCTCAGTAC -> GCCTCAGTACG
AGCCTGACTTA -> GCCTGACTTAG
AGCGATGATGT -> GCGATGATGTT
AGCGCAGTGCG -> GCGCAGTGCGT
AGCGCCCTGAG -> GCGCCCTGAGT
AGCGCCTAAGG -> GCGCCTAAGGA
AGCGCCTTGCA -> GCGCCTTGCAT
AGCGCGCACAC -> GCGCGCACACA
AGCGGAGAACA -> GCGGAGAACAA
AGCGTCAGAGA -> GCGTCAGAGAT
AGCGTCGCAGG -> GCGTCGCAGGA
AGCTAACTCGA -> GCTAACTCGAG
AGCTAAGTCGG -> GCTAAGTCGGT
AGCTATGCAGA -> GCTATGCAGAC
AGCTCTTCAAT -> GCTCTTCAATG
AGCTGAGCTGT -> GCTGAGCTGTT
AGCTGCAGATT -> GCTGCAGATTT
AGCTGCATAAA -> GCTGCATAAAG
AGCTGTAGTGG -> GCTGTAGTGGC
AGCTGTTCACC -> GCTGTTCACCA
AGCTGTTTTTC -> GCTGTTTTTCG
AGCTTAAATAA -> GCTTAAATAAG
AGGAACAAGCC -> GGAACAAGCCC
AGGAACACTCA -> GGAACACTCAT
AGGAATTTAGG -> GGAATTTAGGA
AGGACGCGGTA -> GGACGCGGTAC
AGGACGGAATT -> GGACGGAATTG
AGGAGCCAGAC -> GGAGCCAGACC
AGGAGGTAATT -> GGAGGTAATTA
AGGAGTACTCC -> GGAGTACTCCT
AGGAGTATTGT -> GGAGTATTGTG
AGGCATAGCTG -> GGCATAGCTGC
AGGCCCCTAAG -> GGCCCCTAAGC
AGGCCTGCATA -> GGCCTGCATAG
AGGCTAGCACT -> GGCTAGCACTG
AGGGAAGCTGC -> GGGAAGCTGCA
AGGGAGGCCTG -> GGGAGGCCTGC
AGGGCACTCGA -> GGGCACTCGAA
AGGGGCCAGTC -> GGGGCCAGTCT
AGGGGCCTTAA -> GGGGCCTTAAA
AGGGGCGGACA -> GGGGCGGACAT
AGGGGTGGGCA -> GGGGTGGGCAA
AGGTAAGGGGT -> GGTAAGGGGTG
AGGTAATTAGT -> GGTAATTAGTG
AGGTACTTAAC -> GGTACTTAACC
AGGTAGCGCCT -> GGTAGCGCCTA
AGGTATTTTGC -> GGTATTTTGCC
AGGTCACTATT -> GGTCACTATTT
AGGTTTTGAGC -> GGTTTTGAGCT
AGTAAACAACC -> GTAAACAACCT
AGTAAGTACGC -> GTAAGTACGCC
AGTACGCCCCT -> GTACGCCCCTA
AGTACGCTAAG -> GTACGCTAAGT
AGTACTCCTGT -> GTACTCCTGTT
AGTAGGGGCGG -> GTAGGGGCGGA
AGTATATGAGG -> GTATATGAGGG
AGTATCCATCG -> GTATCCATCGA
AGTATCGGTAA -> GTATCGGTAAA
AGTATTGTGTA -> GTATTGTGTAC
AGTCCGGTTCC -> GTCCGGTTCCG
AGTCCGTGATT -> GTCCGTGATTT
AGTCCTTGCTT -> GTCCTTGCTTT
AGTCGATAGAT -> GTCGATAGATG
AGTCGCTTGTC -> GTCGCTTGTCT
AGTCGGATGCG -> GTCGGATGCGA
AGTCGGTCGAA -> GTCGGTCGAAA
AGTCTGGAACA -> GTCTGGAACAT
AGTGAGTCGAT -> GTGAGTCGATA
AGTGATTTCAT -> GTGATTTCATG
AGTGCCGATCC -> GTGCCGATCCT
AGTGCGAAGAT -> GTGCGAAGATC
AGTGCGTTCGT -> GTGCGTTCGTG
AGTGCTCGCTT -> GTGCTCGCTTA
AGTGGCACACA -> GTGGCACACAT
AGTGGGGGACT -> GTGGGGGACTA
AGTGGTATGCA -> GTGGTATGCAT
AGTGTGAATGT -> GTGTGAATGTC
AGTGTGGCCGA -> GTGTGGCCGAT
AGTGTGGCTGT -> GTGTGGCTGTA
AGTGTTATCCA -> GTGTTATCCAG
AGTTAACGTCT -> GTTAACGTCTA
AGTTAAGGACG -> GTTAAGGACGG
AGTTACACAGC -> GTTACACAGCA
AGTTATATAGC -> GTTATATAGCT
AGTTATGCTTG -> GTTATGCTTGA
AGTTCAACTCC -> GTTCAACTCCC
AGTTCATAGTT -> GTTCATAGTTT
AGTTCTTACAC -> GTTCTTACACA
AGTTGCTGAGT -> GTTGCTGAGTC
AGTTTACACCG -> GTTTACACCGC
AGTTTCCCGAG -> GTTTCCCGAGA
AGTTTGTGCTC -> GTTTGTGCTCG
AGTTTTTAGTG -> GTTTTTAGTGA
ATAAACTGGGT -> TAAACTGGGTT
ATAAAGCTGAG -> TAAAGCTGAGC
ATAACACCCCG -> TAACACCCCGC
ATAACGAGTAA -> TAACGAGTAAA
ATAACGCGGAA -> TAACGCGGAAG
ATAACTCGAGA -> TAACTCGAGAC
ATAAGCCGATA -> TAAGCCGATAA
ATAAGCGATGA -> TAAGCGATGAT
ATAATAAACTG -> TAATAAACTGG
ATACAACGTCG -> TACAACGTCGC
ATACACCGTCA -> TACACCGTCAT
ATACCAGAGCC -> TACCAGAGCCT
ATACCGACCTC -> TACCGACCTCA
ATACGAAGGCT -> TACGAAGGCTA
ATACGCACAAA -> TACGCACAAAG
ATACGCCGTAG -> TACGCCGTAGT
ATACTAGCGCG -> TACTAGCGCGC
ATACTCAAAAT -> TACTCAAAATG
ATAGATAACTC -> TAGATAACTCG
ATAGATGTCTA -> TAGATGTCTAC
ATAGATGTGTG -> TAGATGTGTGA
ATAGCATCTAG -> TAGCATCTAGT
ATAGCTATGCA -> TAGCTATGCAG
ATAGCTGCATA -> TAGCTGCATAA
ATAGGACGCGG -> TAGGACGCGGT
ATAGTATCCAT -> TAGTATCCATC
ATAGTTACACA -> TAGTTACACAG
ATAGTTTTTAG -> TAGTTTTTAGT
ATATAAGCCGA -> TATAAGCCGAT
ATATACCGACC -> TATACCGACCT
ATATAGCTATG -> TATAGCTATGC
ATATGAGGGGC -> TATGAGGGGCC
ATATGCACTGC -> TATGCACTGCA
ATCAAAAAAGG -> TCAAAAAAGGG
ATCAAGGAGTA -> TCAAGGAGTAT
ATCACATTGAA -> TCACATTGAAT
ATCAGACTCAG -> TCAGACTCAGA
ATCAGATTTGT -> TCAGATTTGTG
ATCAGTTTCCC -> TCAGTTTCCCG
ATCCAGCATGC -> TCCAGCATGCC
ATCCAGCCCGC -> TCCAGCCCGCG
ATCCAGTTCAA -> TCCAGTTCAAC
ATCCATAGTTA -> TCCATAGTTAC
ATCCATCGACG -> TCCATCGACGT
ATCCCCGAAGC -> TCCCCGAAGCC
ATCCGCCTGGT -> TCCGCCTGGTC
ATCCTGAACCG -> TCCTGAACCGC
ATCCTGGCGGG -> TCCTGGCGGGT
ATCGACGTTTA -> TCGACGTTTAT
ATCGCAGATCA -> TCGCAGATCAG
ATCGGTAAAGC -> TCGGTAAAGCC
ATCGTAAGTTT -> TCGTAAGTTTA
ATCGTATCCAG -> TCGTATCCAGC
ATCGTTTTGGT -> TCGTTTTGGTC
ATCTAGTGTGG -> TCTAGTGTGGC
ATCTGCGCCAA -> TCTGCGCCAAT
ATCTTCTGAAG -> TCTTCTGAAGT
ATCTTTCCCCC -> TCTTTCCCCCA
ATGAAACTTCT -> TGAAACTTCTG
ATGAGCAACGT -> TGAGCAACGTG
ATGAGCGGAGA -> TGAGCGGAGAA
ATGAGCTAACT -> TGAGCTAACTC
ATGAGGGGCCA -> TGAGGGGCCAG
ATGAGTATCGG -> TGAGTATCGGT
ATGATGTTTCA -> TGATGTTTCAG
ATGATTGAGCA -> TGATTGAGCAT
ATGCACTGCAG -> TGCACTGCAGA
ATGCAGACTCC -> TGCAGACTCCT
ATGCAGCAAAG -> TGCAGCAAAGA
ATGCAGTTAAC -> TGCAGTTAACG
ATGCATTGACG -> TGCATTGACGT
ATGCCGTCAGT -> TGCCGTCAGTG
ATGCCTCGGAC -> TGCCTCGGACT
ATGCCTTGGCT -> TGCCTTGGCTC
ATGCGACTGGG -> TGCGACTGGGC
ATGCGCGCCTA -> TGCGCGCCTAC
ATGCTCTGTAT -> TGCTCTGTATT
ATGCTTGATAC -> TGCTTGATACG
ATGGAATTGCC -> TGGAATTGCCA
ATGGAGTATAT -> TGGAGTATATG
ATGGGAAGAGA -> TGGGAAGAGAC
ATGGTAGAAGA -> TGGTAGAAGAC
ATGGTTGTAGC -> TGGTTGTAGCT
ATGTAACAAAT -> TGTAACAAATC
ATGTACTGCAC -> TGTACTGCACC
ATGTCCAAAGG -> TGTCCAAAGGC
ATGTCCTCTAT -> TGTCCTCTATG
ATGTCGACTGG -> TGTCGACTGGG
ATGTCTACCGA -> TGTCTACCGAT
ATGTCTTAATA -> TGTCTTAATAC
ATGTGTCTGTT -> TGTGTCTGTTA
ATGTGTGACCC -> TGTGTGACCCG
ATGTTATTATT -> TGTTATTATTG
ATGTTCATGGA -> TGTTCATGGAA
ATGTTTCAGCG -> TGTTTCAGCGC
ATTAAATCGTT -> TTAAATCGTTT
ATTAGGTAGCG -> TTAGGTAGCGC
ATTAGTGTGAA -> TTAGTGTGAAT
ATTATTGTTGT -> TTATTGTTGTC
ATTCAACCAGG -> TTCAACCAGGT
ATTCACAGCCC -> TTCACAGCCCA
ATTCATCCAGT -> TTCATCCAGTT
ATTCCAGAATC -> TTCCAGAATCA
ATTCCTTGTGT -> TTCCTTGTGTA
ATTCTGACCGT -> TTCTGACCGTG
ATTGAATACTA -> TTGAATACTAG
ATTGACGTTGG -> TTGACGTTGGC
ATTGAGCATGC -> TTGAGCATGCA
ATTGCCACCAT -> TTGCCACCATG
ATTGCTATACG -> TTGCTATACGC
ATTGGCAACAC -> TTGGCAACACA
ATTGTGGAAGG -> TTGTGGAAGGG
ATTGTGTACAA -> TTGTGTACAAT
ATTGTTGTCAA -> TTGTTGTCAAG
ATTTAACCAGT -> TTTAACCAGTG
ATTTAGGAGGT -> TTTAGGAGGTA
ATTTCATGTCG -> TTTCATGTCGA
ATTTGACAACT -> TTTGACAACTG
ATTTGGCTCAC -> TTTGGCTCACT
ATTTGGTAACG -> TTTGGTAACGA
ATTTGTGTAAT -> TTTGTGTAATG
ATTTTGCCTAT -> TTTTGCCTATG
ATTTTTTATCA -> TTTTTTATCAG
CAAAAAAGGGC -> AAAAAAGGGCA
CAAAATGATTG -> AAAATGATTGA
CAAAGACTGGG -> AAAGACTGGGC
CAAAGGCCCCT -> AAAGGCCCCTA
CAAAGGGAAGC -> AAAGGGAAGCT
CAAATCACATT -> AAATCACATTG
CAACACATGTA -> AACACATGTAC
CAACACTCTCG -> AACACTCTCGC
CAACCAGGTCA -> AACCAGGTCAC
CAACCCGCGGA -> AACCCGCGGAG
CAACCTGTCCC -> AACCTGTCCCC
CAACCTTTAAC -> AACCTTTAACG
CAACGACACAA -> AACGACACAAC
CAACGACGTAG -> AACGACGTAGC
CAACGTCGCCG -> AACGTCGCCGT
CAACGTGGTAA -> AACGTGGTAAC
CAACTCCCGTG -> AACTCCCGTGT
CAACTGGCAAC -> AACTGGCAACG
CAAGAACCGGG -> AAGAACCGGGC
CAAGCCCGGAG -> AAGCCCGGAGC
CAAGGAGTATT -> AAGGAGTATTG
CAAGGCATAGC -> AAGGCATAGCT
CAAGGGGCCTT -> AAGGGGCCTTA
CAATACGAAGG -> AATACGAAGGC
CAATACTCAAA -> AATACTCAAAA
CAATGAGTATC -> AATGAGTATCG
CAATGCCGTCA -> AATGCCGTCAG
CAATGCTCTGT -> AATGCTCTGTA
CAATGGAGTAT -> AATGGAGTATA
CAATGGTAGAA -> AATGGTAGAAG
CACAAAGGGAA -> ACAAAGGGAAG
CACAACCTTTA -> ACAACCTTTAA
CACACAGCTGT -> ACACAGCTGTT
CACACATTCAT -> ACACATTCATC
CACAGCACGCG -> ACAGCACGCGT
CACAGCCCAGG -> ACAGCCCAGGT
CACAGCTGTTC -> ACAGCTGTTCA
CACAGTCCGTG -> ACAGTCCGTGA
CACATACCAGA -> ACATACCAGAG
CACATGTACTG -> ACATGTACTGC
CACATTCATCC -> ACATTCATCCA
CACATTGAATA -> ACATTGAATAC
CACCAACCCGC -> ACCAACCCGCG
CACCAGTGGGG -> ACCAGTGGGGG
CACCCCGCGCA -> ACCCCGCGCAG
CACCGCATAAC -> ACCGCATAACG
CACCGGATAAT -> ACCGGATAATA
CACCGTCATAT -> ACCGTCATATA
CACGCGTATCG -> ACGCGTATCGC
CACTATATGCA -> ACTATATGCAC
CACTATTTGGC -> ACTATTTGGCT
CACTCATGAAA -> ACTCATGAAAC
CACTCGAATAG -> ACTCGAATAGG
CACTCTCGCAC -> ACTCTCGCACC
CACTGCAGAGG -> ACTGCAGAGGT
CACTGCAGTGT -> ACTGCAGTGTG
CACTTAATAGA -> ACTTAATAGAT
CAGAATCAGAT -> AGAATCAGATT
CAGACCCGTAC -> AGACCCGTACG
CAGACTCAGAT -> AGACTCAGATC
CAGACTCCTAT -> AGACTCCTATT
CAGAGATGCGC -> AGAGATGCGCG
CAGAGCCTGAC -> AGAGCCTGACT
CAGAGGTAAGG -> AGAGGTAAGGG
CAGATCAGACT -> AGATCAGACTC
CAGATCCGCCT -> AGATCCGCCTG
CAGATCTGCGC -> AGATCTGCGCC
CAGATTGGCAA -> AGATTGGCAAC
CAGATTTAACC -> AGATTTAACCA
CAGATTTGTGT -> AGATTTGTGTA
CAGCAAAGACT -> AGCAAAGACTG
CAGCACGCGTA -> AGCACGCGTAT
CAGCATGCCTT -> AGCATGCCTTG
CAGCCCAGGTA -> AGCCCAGGTAT
CAGCCCGCGAT -> AGCCCGCGATG
CAGCCTCAGTA -> AGCCTCAGTAC
CAGCGCAGTGC -> AGCGCAGTGCG
CAGCTCTTCAA -> AGCTCTTCAAT
CAGCTGTTCAC -> AGCTGTTCACC
CAGGAGCCAGA -> AGGAGCCAGAC
CAGGTATTTTG -> AGGTATTTTGC
CAGGTCACTAT -> AGGTCACTATT
CAGTAAGTACG -> AGTAAGTACGC
CAGTACGCTAA -> AGTACGCTAAG
CAGTCCGGTTC -> AGTCCGGTTCC
CAGTCCGTGAT -> AGTCCGTGATT
CAGTCTGGAAC -> AGTCTGGAACA
CAGTGATTTCA -> AGTGATTTCAT
CAGTGCCGATC -> AGTGCCGATCC
CAGTGCGAAGA -> AGTGCGAAGAT
CAGTGCGTTCG -> AGTGCGTTCGT
CAGTGCTCGCT -> AGTGCTCGCTT
CAGTGGGGGAC -> AGTGGGGGACT
CAGTGTGGCCG -> AGTGTGGCCGA
CAGTGTTATCC -> AGTGTTATCCA
CAGTTAACGTC -> AGTTAACGTCT
CAGTTAAGGAC -> AGTTAAGGACG
CAGTTCAACTC -> AGTTCAACTCC
CAGTTTCCCGA -> AGTTTCCCGAG
CATAAAGCTGA -> ATAAAGCTGAG
CATAACGAGTA -> ATAACGAGTAA
CATAACGCGGA -> ATAACGCGGAA
CATACCAGAGC -> ATACCAGAGCC
CATAGATGTCT -> ATAGATGTCTA
CATAGCTGCAT -> ATAGCTGCATA
CATAGTTACAC -> ATAGTTACACA
CATAGTTTTTA -> ATAGTTTTTAG
CATATAAGCCG -> ATATAAGCCGA
CATATACCGAC -> ATATACCGACC
CATCCAGTTCA -> ATCCAGTTCAA
CATCGACGTTT -> ATCGACGTTTA
CATCTAGTGTG -> ATCTAGTGTGG
CATCTTCTGAA -> ATCTTCTGAAG
CATGAAACTTC -> ATGAAACTTCT
CATGCAGCAAA -> ATGCAGCAAAG
CATGCCTTGGC -> ATGCCTTGGCT
CATGGAATTGC -> ATGGAATTGCC
CATGTAACAAA -> ATGTAACAAAT
CATGTACTGCA -> ATGTACTGCAC
CATGTCGACTG -> ATGTCGACTGG
CATGTTATTAT -> ATGTTATTATT
CATTAAATCGT -> ATTAAATCGTT
CATTCATCCAG -> ATTCATCCAGT
CATTGAATACT -> ATTGAATACTA
CATTGACGTTG -> ATTGACGTTGG
CATTTGGTAAC -> ATTTGGTAACG
CCAAAGGCCCC -> CAAAGGCCCCT
CCAACACTCTC -> CAACACTCTCG
CCAACCCGCGG -> CAACCCGCGGA
CCAATACGAAG -> CAATACGAAGG
CCAATGGAGTA -> CAATGGAGTAT
CCACCATGTCC -> CACCATGTCCT
CCAGAATCAGA -> CAGAATCAGAT
CCAGACCCGTA -> CAGACCCGTAC
CCAGAGCCTGA -> CAGAGCCTGAC
CCAGCATGCCT -> CAGCATGCCTT
CCAGCCCGCGA -> CAGCCCGCGAT
CCAGGTATTTT -> CAGGTATTTTG
CCAGGTCACTA -> CAGGTCACTAT
CCAGTCTGGAA -> CAGTCTGGAAC
CCAGTGGGGGA -> CAGTGGGGGAC
CCAGTGTTATC -> CAGTGTTATCC
CCAGTTAAGGA -> CAGTTAAGGAC
CCAGTTCAACT -> CAGTTCAACTC
CCATAGTTACA -> CATAGTTACAC
CCATATAAGCC -> CATATAAGCCG
CCATCGACGTT -> CATCGACGTTT
CCCAACACTCT -> CCAACACTCTC
CCCAGGTATTT -> CCAGGTATTTT
CCCAGTTAAGG -> CCAGTTAAGGA
CCCATATAAGC -> CCATATAAGCC
CCCCAACACTC -> CCCAACACTCT
CCCCAGTTAAG -> CCCAGTTAAGG
CCCCCAACACT -> CCCCAACACTC
CCCCCAGTTAA -> CCCCAGTTAAG
CCCCCGGGTAT -> CCCCGGGTATG
CCCCCTTGCGG -> CCCCTTGCGGA
CCCCGAAGCCG -> CCCGAAGCCGT
CCCCGAATGCA -> CCCGAATGCAG
CCCCGCGCAGA -> CCCGCGCAGAT
CCCCGGGTATG -> CCCGGGTATGT
CCCCTAAGCCG -> CCCTAAGCCGG
CCCCTAGCACT -> CCCTAGCACTA
CCCCTTGCGGA -> CCCTTGCGGAA
CCCGAAGCCGT -> CCGAAGCCGTA
CCCGAATGCAG -> CCGAATGCAGT
CCCGAGAGACA -> CCGAGAGACAA
CCCGCGATGAG -> CCGCGATGAGC
CCCGCGCAGAT -> CCGCGCAGATT
CCCGCGGAGTT -> CCGCGGAGTTC
CCCGGAGCAGT -> CCGGAGCAGTA
CCCGGGTATGT -> CCGGGTATGTG
CCCGTACGGAT -> CCGTACGGATC
CCCGTAGGAAC -> CCGTAGGAACA
CCCGTGTACAT -> CCGTGTACATG
CCCTAAGCCGG -> CCTAAGCCGGG
CCCTAGCACTA -> CCTAGCACTAT
CCCTGAGTTAT -> CCTGAGTTATG
CCCTTGCGGAA -> CCTTGCGGAAG
CCGAAGCCGTA -> CGAAGCCGTAC
CCGAATGCAGT -> CGAATGCAGTT
CCGACCTCAGT -> CGACCTCAGTG
CCGAGAGACAA -> CGAGAGACAAC
CCGAGTTGCTG -> CGAGTTGCTGA
CCGATAACACC -> CGATAACACCC
CCGATCCTGGC -> CGATCCTGGCG
CCGATGGGAAG -> CGATGGGAAGA
CCGATTCACAG -> CGATTCACAGC
CCGCATAACGC -> CGCATAACGCG
CCGCCTGGTCA -> CGCCTGGTCAA
CCGCGATGAGC -> CGCGATGAGCT
CCGCGCAGATT -> CGCGCAGATTG
CCGCGGAGTTC -> CGCGGAGTTCT
CCGCGTGAGAG -> CGCGTGAGAGG
CCGCTAGATAG -> CGCTAGATAGC
CCGGAGCAGTA -> CGGAGCAGTAA
CCGGATAATAA -> CGGATAATAAA
CCGGGCGGTAG -> CGGGCGGTAGC
CCGGGCTTTGT -> CGGGCTTTGTC
CCGGGTACTTA -> CGGGTACTTAA
CCGGGTATGTG -> CGGGTATGTGT
CCGGTTCCGCT -> CGGTTCCGCTA
CCGTACAGTCC -> CGTACAGTCCG
CCGTACGGATC -> CGTACGGATCC
CCGTAGGAACA -> CGTAGGAACAC
CCGTAGTTATA -> CGTAGTTATAT
CCGTCAGTGCG -> CGTCAGTGCGA
CCGTCATATAC -> CGTCATATACC
CCGTGACCGAG -> CGTGACCGAGT
CCGTGATTTGA -> CGTGATTTGAC
CCGTGATTTTT -> CGTGATTTTTT
CCGTGTACATG -> CGTGTACATGT
CCGTGTTGGTA -> CGTGTTGGTAT
CCTAAGCCGGG -> CTAAGCCGGGT
CCTAAGGAATT -> CTAAGGAATTT
CCTACGGTATA -> CTACGGTATAG
CCTACTTACGG -> CTACTTACGGG
CCTAGCACTAT -> CTAGCACTATA
CCTATGTCTTA -> CTATGTCTTAA
CCTATTAGGTA -> CTATTAGGTAG
CCTCAGTACGC -> CTCAGTACGCT
CCTCAGTGCCG -> CTCAGTGCCGA
CCTCGGACTGT -> CTCGGACTGTG
CCTCTATGCCT -> CTCTATGCCTC
CCTGAACCGCG -> CTGAACCGCGT
CCTGACTTAGG -> CTGACTTAGGT
CCTGAGTTATG -> CTGAGTTATGC
CCTGCATAGAT -> CTGCATAGATG
CCTGGCGGGTA -> CTGGCGGGTAT
CCTGGTCAATG -> CTGGTCAATGC
CCTGTCCCCGA -> CTGTCCCCGAA
CCTGTTGTAAC -> CTGTTGTAACC
CCTTAAATTGT -> CTTAAATTGTG
CCTTGCATTTG -> CTTGCATTTGG
CCTTGCGGAAG -> CTTGCGGAAGC
CCTTGCTTTCG -> CTTGCTTTCGT
CCTTGGCTCAG -> CTTGGCTCAGC
CCTTGTGTAGC -> CTTGTGTAGCT
CCTTTAACGCT -> CTTTAACGCTC
CCTTTACTTGA -> CTTTACTTGAG
CGAAAGCGTCA -> GAAAGCGTCAG
CGAAGATCGTA -> GAAGATCGTAA
CGAAGCCGTAC -> GAAGCCGTACA
CGAAGGCTAGC -> GAAGGCTAGCA
CGAATAGGACG -> GAATAGGACGC
CGAATGCAGTT -> GAATGCAGTTA
CGACACAACCT -> GACACAACCTT
CGACCTCAGTG -> GACCTCAGTGC
CGACGTAGCGC -> GACGTAGCGCC
CGACGTTTATG -> GACGTTTATGA
CGACTGGGCTG -> GACTGGGCTGC
CGACTGGGTTT -> GACTGGGTTTC
CGAGACCGTGA -> GAGACCGTGAT
CGAGAGACAAC -> GAGAGACAACG
CGAGGTACTTA -> GAGGTACTTAA
CGAGTAAACAA -> GAGTAAACAAC
CGAGTAGGGGC -> GAGTAGGGGCG
CGAGTTGCTGA -> GAGTTGCTGAG
CGATAACACCC -> GATAACACCCC
CGATACAACGT -> GATACAACGTC
CGATAGATGTG -> GATAGATGTGT
CGATCCTGGCG -> GATCCTGGCGG
CGATCTTTCCC -> GATCTTTCCCC
CGATGAGCTAA -> GATGAGCTAAC
CGATGATGTTT -> GATGATGTTTC
CGATGGGAAGA -> GATGGGAAGAG
CGATGTTCATG -> GATGTTCATGG
CGATTCACAGC -> GATTCACAGCC
CGCACAAAGGG -> GCACAAAGGGA
CGCACACAGCT -> GCACACAGCTG
CGCACCAACCC -> GCACCAACCCG
CGCAGATCAGA -> GCAGATCAGAC
CGCAGATTGGC -> GCAGATTGGCA
CGCAGGAGCCA -> GCAGGAGCCAG
CGCAGTGCGTT -> GCAGTGCGTTC
CGCATAACGCG -> GCATAACGCGG
CGCCAATGGAG -> GCCAATGGAGT
CGCCCCTAGCA -> GCCCCTAGCAC
CGCCCTGAGTT -> GCCCTGAGTTA
CGCCGTAGTTA -> GCCGTAGTTAT
CGCCGTGTTGG -> GCCGTGTTGGT
CGCCTAAGGAA -> GCCTAAGGAAT
CGCCTACTTAC -> GCCTACTTACG
CGCCTGGTCAA -> GCCTGGTCAAT
CGCCTTGCATT -> GCCTTGCATTT
CGCGAGGTACT -> GCGAGGTACTT
CGCGATGAGCT -> GCGATGAGCTA
CGCGCACACAG -> GCGCACACAGC
CGCGCAGATTG -> GCGCAGATTGG
CGCGCCTACTT -> GCGCCTACTTA
CGCGGAAGTCC -> GCGGAAGTCCT
CGCGGAGTTCT -> GCGGAGTTCTT
CGCGGTACAAT -> GCGGTACAATA
CGCGTATCGCA -> GCGTATCGCAG
CGCGTGAGAGG -> GCGTGAGAGGA
CGCTAAGTTTG -> GCTAAGTTTGT
CGCTAGATAGC -> GCTAGATAGCA
CGCTCATCTTC -> GCTCATCTTCT
CGCTTAAGTCG -> GCTTAAGTCGC
CGCTTGTCTGG -> GCTTGTCTGGA
CGGAAGCAGTG -> GGAAGCAGTGC
CGGAAGTCCTT -> GGAAGTCCTTG
CGGAATTGCTA -> GGAATTGCTAT
CGGACATTAAA -> GGACATTAAAT
CGGACTGTGAA -> GGACTGTGAAG
CGGAGAACAAT -> GGAGAACAATG
CGGAGCAGTAA -> GGAGCAGTAAG
CGGAGTTCTTA -> GGAGTTCTTAC
CGGATAATAAA -> GGATAATAAAC
CGGATCCCCGA -> GGATCCCCGAA
CGGATGCGACT -> GGATGCGACTG
CGGGCGGTAGC -> GGGCGGTAGCA
CGGGCTTTGTC -> GGGCTTTGTCA
CGGGGTCTCCC -> GGGGTCTCCCA
CGGGTACTTAA -> GGGTACTTAAC
CGGGTATGGTT -> GGGTATGGTTG
CGGGTATGTGT -> GGGTATGTGTC
CGGTAAAGCCC -> GGTAAAGCCCC
CGGTACAATAC -> GGTACAATACT
CGGTAGCACAT -> GGTAGCACATA
CGGTATAGTAT -> GGTATAGTATC
CGGTCGAAAGC -> GGTCGAAAGCG
CGGTCTGAAAC -> GGTCTGAAACT
CGGTTCCGCTA -> GGTTCCGCTAG
CGTAAGTTTAC -> GTAAGTTTACA
CGTACAGTCCG -> GTACAGTCCGG
CGTACAGTGAT -> GTACAGTGATT
CGTACGGATCC -> GTACGGATCCC
CGTAGCGCCCT -> GTAGCGCCCTG
CGTAGCGCCTT -> GTAGCGCCTTG
CGTAGGAACAC -> GTAGGAACACT
CGTAGTTATAT -> GTAGTTATATA
CGTATCCAGCC -> GTATCCAGCCC
CGTATCGCAGA -> GTATCGCAGAT
CGTCAGAGATG -> GTCAGAGATGC
CGTCAGTGCGA -> GTCAGTGCGAA
CGTCATATACC -> GTCATATACCG
CGTCGCAGGAG -> GTCGCAGGAGC
CGTCGCCGTGT -> GTCGCCGTGTT
CGTCGTAGCGC -> GTCGTAGCGCC
CGTCTAGGAAC -> GTCTAGGAACA
CGTGACCGAGT -> GTGACCGAGTT
CGTGAGAGGAG -> GTGAGAGGAGT
CGTGATTTGAC -> GTGATTTGACA
CGTGATTTTTT -> GTGATTTTTTA
CGTGCCCCCTT -> GTGCCCCCTTG
CGTGGTAACAA -> GTGGTAACAAG
CGTGTACATGT -> GTGTACATGTA
CGTGTTGGTAT -> GTGTTGGTATT
CGTTCGTGCCC -> GTTCGTGCCCC
CGTTGGCTCTT -> GTTGGCTCTTA
CGTTTATGAGC -> GTTTATGAGCA
CGTTTTGGTCT -> GTTTTGGTCTT
CTAACTCGAGT -> TAACTCGAGTA
CTAAGCCGGGT -> TAAGCCGGGTA
CTAAGGAATTT -> TAAGGAATTTA
CTAAGTCGGTC -> TAAGTCGGTCG
CTAAGTTTGTG -> TAAGTTTGTGC
CTAATCCATAG -> TAATCCATAGT
CTACCGATTCA -> TACCGATTCAC
CTACGGTATAG -> TACGGTATAGT
CTACTTACGGG -> TACTTACGGGG
CTAGACCTTTA -> TAGACCTTTAC
CTAGATAGCAT -> TAGATAGCATC
CTAGCACTATA -> TAGCACTATAT
CTAGCACTGCA -> TAGCACTGCAG
CTAGCGCGCAC -> TAGCGCGCACA
CTAGGAACAAG -> TAGGAACAAGC
CTAGTGTGGCT -> TAGTGTGGCTG
CTATACGCCGT -> TATACGCCGTA
CTATATGCACT -> TATATGCACTG
CTATGCAGACT -> TATGCAGACTC
CTATGCCTCGG -> TATGCCTCGGA
CTATGTCTTAA -> TATGTCTTAAT
CTATTAGGTAG -> TATTAGGTAGC
CTATTTGGCTC -> TATTTGGCTCA
CTCAAAATGAT -> TCAAAATGATT
CTCACTTAATA -> TCACTTAATAG
CTCAGATCTGC -> TCAGATCTGCG
CTCAGCCTCAG -> TCAGCCTCAGT
CTCAGTACGCT -> TCAGTACGCTA
CTCAGTGCCGA -> TCAGTGCCGAT
CTCATCTTCTG -> TCATCTTCTGA
CTCATGAAACT -> TCATGAAACTT
CTCCAATACGA -> TCCAATACGAA
CTCCCATATAA -> TCCCATATAAG
CTCCCGTGTAC -> TCCCGTGTACA
CTCCTATTAGG -> TCCTATTAGGT
CTCCTGTTGTA -> TCCTGTTGTAA
CTCGAATAGGA -> TCGAATAGGAC
CTCGAGACCGT -> TCGAGACCGTG
CTCGAGTAGGG -> TCGAGTAGGGG
CTCGCACCAAC -> TCGCACCAACC
CTCGCTTAAGT -> TCGCTTAAGTC
CTCGGACTGTG -> TCGGACTGTGA
CTCGTACAGTG -> TCGTACAGTGA
CTCTATGCCTC -> TCTATGCCTCG
CTCTCCAATAC -> TCTCCAATACG
CTCTCGCACCA -> TCTCGCACCAA
CTCTGTATTCC -> TCTGTATTCCT
CTCTTAAGATT -> TCTTAAGATTC
CTCTTCAATGA -> TCTTCAATGAG
CTGAAACTTGA -> TGAAACTTGAG
CTGAACCGCGT -> TGAACCGCGTG
CTGAAGTGGTA -> TGAAGTGGTAT
CTGACCGTGAC -> TGACCGTGACC
CTGACTTAGGT -> TGACTTAGGTT
CTGAGCTGTTT -> TGAGCTGTTTT
CTGAGTCGGAT -> TGAGTCGGATG
CTGAGTTATGC -> TGAGTTATGCT
CTGCACCGGAT -> TGCACCGGATA
CTGCAGAGGTA -> TGCAGAGGTAA
CTGCAGATCCG -> TGCAGATCCGC
CTGCAGATTTA -> TGCAGATTTAA
CTGCAGTGTGG -> TGCAGTGTGGC
CTGCATAAAGC -> TGCATAAAGCT
CTGCATAGATG -> TGCATAGATGT
CTGCGCCAATG -> TGCGCCAATGG
CTGGAACATGT -> TGGAACATGTT
CTGGAATCAAA -> TGGAATCAAAA
CTGGAATGTCC -> TGGAATGTCCA
CTGGCAACGAC -> TGGCAACGACG
CTGGCGGGTAT -> TGGCGGGTATG
CTGGGCTGCAG -> TGGGCTGCAGA
CTGGGCTTACG -> TGGGCTTACGG
CTGGGTTATCA -> TGGGTTATCAA
CTGGGTTTCGA -> TGGGTTTCGAT
CTGGTCAATGC -> TGGTCAATGCT
CTGTACGATAC -> TGTACGATACA
CTGTAGTGGCA -> TGTAGTGGCAC
CTGTATTCCTT -> TGTATTCCTTG
CTGTCCCCGAA -> TGTCCCCGAAT
CTGTGAAGTTC -> TGTGAAGTTCA
CTGTTATCGTA -> TGTTATCGTAT
CTGTTCACCAG -> TGTTCACCAGT
CTGTTGTAACC -> TGTTGTAACCG
CTGTTTTTCGC -> TGTTTTTCGCG
CTTAAATAAGC -> TTAAATAAGCG
CTTAAATTGTG -> TTAAATTGTGG
CTTAACCCCCG -> TTAACCCCCGG
CTTAACCTACG -> TTAACCTACGG
CTTAAGATTCC -> TTAAGATTCCA
CTTAAGTCGCT -> TTAAGTCGCTT
CTTAATACACC -> TTAATACACCG
CTTAATAGATA -> TTAATAGATAA
CTTAATTCAAC -> TTAATTCAACC
CTTACACAGTC -> TTACACAGTCC
CTTACGGGGTC -> TTACGGGGTCT
CTTACGGTCTG -> TTACGGTCTGA
CTTAGGTTTTG -> TTAGGTTTTGA
CTTCAATGAGT -> TTCAATGAGTA
CTTCAGCTCTT -> TTCAGCTCTTC
CTTCTGAAGTG -> TTCTGAAGTGG
CTTCTGGAATG -> TTCTGGAATGT
CTTGAGATCCT -> TTGAGATCCTG
CTTGAGCGTCG -> TTGAGCGTCGC
CTTGATACGCA -> TTGATACGCAC
CTTGCATTTGG -> TTGCATTTGGT
CTTGCGGAAGC -> TTGCGGAAGCA
CTTGCTTTCGT -> TTGCTTTCGTC
CTTGGCTCAGC -> TTGGCTCAGCC
CTTGTCTGGAA -> TTGTCTGGAAT
CTTGTGTAGCT -> TTGTGTAGCTT
CTTTAACGCTC -> TTTAACGCTCA
CTTTACTTGAG -> TTTACTTGAGC
CTTTCCCCCAG -> TTTCCCCCAGT
CTTTCGTCGTA -> TTTCGTCGTAG
CTTTGTCATAA -> TTTGTCATAAC
GAAACTTCTGG -> AAACTTCTGGA
GAAACTTGAGA -> AAACTTGAGAT
GAAAGCGTCAG -> AAAGCGTCAGA
GAACAAGCCCG -> AACAAGCCCGG
GAACAATGGTA -> AACAATGGTAG
GAACACTCATG -> AACACTCATGA
GAACATGTTAT -> AACATGTTATT
GAACCGCGTGA -> AACCGCGTGAG
GAACCGGGCGG -> AACCGGGCGGT
GAAGACTAATC -> AAGACTAATCC
GAAGAGACTTA -> AAGAGACTTAA
GAAGATCGTAA -> AAGATCGTAAG
GAAGCAGTGCT -> AAGCAGTGCTC
GAAGCCGTACA -> AAGCCGTACAG
GAAGCTGCAGA -> AAGCTGCAGAT
GAAGGCTAGCA -> AAGGCTAGCAC
GAAGGGAGGCC -> AAGGGAGGCCT
GAAGTCCTTGC -> AAGTCCTTGCT
GAAGTGGTATG -> AAGTGGTATGC
GAAGTTCATAG -> AAGTTCATAGT
GAATACTAGCG -> AATACTAGCGC
GAATAGGACGC -> AATAGGACGCG
GAATCAAAAAA -> AATCAAAAAAG
GAATCAGATTT -> AATCAGATTTG
GAATGCAGTTA -> AATGCAGTTAA
GAATGTCCAAA -> AATGTCCAAAG
GAATGTCCTCT -> AATGTCCTCTA
GAATTGCCACC -> AATTGCCACCA
GAATTGCTATA -> AATTGCTATAC
GAATTTAGGAG -> AATTTAGGAGG
GACAACGACAC -> ACAACGACACA
GACAACTGGCA -> ACAACTGGCAA
GACACAACCTT -> ACACAACCTTT
GACATTAAATC -> ACATTAAATCG
GACCCGTACGG -> ACCCGTACGGA
GACCCGTAGGA -> ACCCGTAGGAA
GACCGAGTTGC -> ACCGAGTTGCT
GACCGTGACCG -> ACCGTGACCGA
GACCGTGATTT -> ACCGTGATTTT
GACCTCAGTGC -> ACCTCAGTGCC
GACCTTTACTT -> ACCTTTACTTG
GACGCGGTACA -> ACGCGGTACAA
GACGGAATTGC -> ACGGAATTGCT
GACGTAGCGCC -> ACGTAGCGCCT
GACGTTGGCTC -> ACGTTGGCTCT
GACGTTTATGA -> ACGTTTATGAG
GACTAATCCAT -> ACTAATCCATA
GACTAGACCTT -> ACTAGACCTTT
GACTCAGATCT -> ACTCAGATCTG
GACTCCTATTA -> ACTCCTATTAG
GACTGGGCTGC -> ACTGGGCTGCA
GACTGGGCTTA -> ACTGGGCTTAC
GACTGGGTTTC -> ACTGGGTTTCG
GACTGTGAAGT -> ACTGTGAAGTT
GACTTAATTCA -> ACTTAATTCAA
GACTTAGGTTT -> ACTTAGGTTTT
GAGAACAATGG -> AGAACAATGGT
GAGACAACGAC -> AGACAACGACA
GAGACCGTGAT -> AGACCGTGATT
GAGACTTAATT -> AGACTTAATTC
GAGAGACAACG -> AGAGACAACGA
GAGAGGAGTAC -> AGAGGAGTACT
GAGATCCTGAA -> AGATCCTGAAC
GAGATGCGCGC -> AGATGCGCGCC
GAGCAACGTGG -> AGCAACGTGGT
GAGCAGTAAGT -> AGCAGTAAGTA
GAGCATGCAGC -> AGCATGCAGCA
GAGCCAGACCC -> AGCCAGACCCG
GAGCCTGACTT -> AGCCTGACTTA
GAGCGGAGAAC -> AGCGGAGAACA
GAGCGTCGCAG -> AGCGTCGCAGG
GAGCTAACTCG -> AGCTAACTCGA
GAGCTGTAGTG -> AGCTGTAGTGG
GAGCTGTTTTT -> AGCTGTTTTTC
GAGGAGTACTC -> AGGAGTACTCC
GAGGCCTGCAT -> AGGCCTGCATA
GAGGGGCCAGT -> AGGGGCCAGTC
GAGGTAAGGGG -> AGGTAAGGGGT
GAGGTAATTAG -> AGGTAATTAGT
GAGGTACTTAA -> AGGTACTTAAC
GAGTAAACAAC -> AGTAAACAACC
GAGTACTCCTG -> AGTACTCCTGT
GAGTAGGGGCG -> AGTAGGGGCGG
GAGTATATGAG -> AGTATATGAGG
GAGTATCGGTA -> AGTATCGGTAA
GAGTATTGTGT -> AGTATTGTGTA
GAGTCGATAGA -> AGTCGATAGAT
GAGTCGGATGC -> AGTCGGATGCG
GAGTTATGCTT -> AGTTATGCTTG
GAGTTCTTACA -> AGTTCTTACAC
GAGTTGCTGAG -> AGTTGCTGAGT
GATAACACCCC -> ATAACACCCCG
GATAACTCGAG -> ATAACTCGAGA
GATAATAAACT -> ATAATAAACTG
GATACAACGTC -> ATACAACGTCG
GATACGCACAA -> ATACGCACAAA
GATAGATGTGT -> ATAGATGTGTG
GATAGCATCTA -> ATAGCATCTAG
GATCAGACTCA -> ATCAGACTCAG
GATCCCCGAAG -> ATCCCCGAAGC
GATCCGCCTGG -> ATCCGCCTGGT
GATCCTGAACC -> ATCCTGAACCG
GATCCTGGCGG -> ATCCTGGCGGG
GATCGTAAGTT -> ATCGTAAGTTT
GATCTGCGCCA -> ATCTGCGCCAA
GATCTTTCCCC -> ATCTTTCCCCC
GATGAGCTAAC -> ATGAGCTAACT
GATGATGTTTC -> ATGATGTTTCA
GATGCGACTGG -> ATGCGACTGGG
GATGCGCGCCT -> ATGCGCGCCTA
GATGGGAAGAG -> ATGGGAAGAGA
GATGTCTACCG -> ATGTCTACCGA
GATGTGTGACC -> ATGTGTGACCC
GATGTTCATGG -> ATGTTCATGGA
GATGTTTCAGC -> ATGTTTCAGCG
GATTCACAGCC -> ATTCACAGCCC
GATTCCAGAAT -> ATTCCAGAATC
GATTGAGCATG -> ATTGAGCATGC
GATTGGCAACA -> ATTGGCAACAC
GATTTAACCAG -> ATTTAACCAGT
GATTTCATGTC -> ATTTCATGTCG
GATTTGACAAC -> ATTTGACAACT
GATTTGTGTAA -> ATTTGTGTAAT
GATTTTTTATC -> ATTTTTTATCA
GCAAAGACTGG -> CAAAGACTGGG
GCAACACATGT -> CAACACATGTA
GCAACGACGTA -> CAACGACGTAG
GCAACGTGGTA -> CAACGTGGTAA
GCAAGGCATAG -> CAAGGCATAGC
GCACAAAGGGA -> CACAAAGGGAA
GCACACAGCTG -> CACACAGCTGT
GCACACATTCA -> CACACATTCAT
GCACATACCAG -> CACATACCAGA
GCACCAACCCG -> CACCAACCCGC
GCACCGGATAA -> CACCGGATAAT
GCACGCGTATC -> CACGCGTATCG
GCACTATATGC -> CACTATATGCA
GCACTCGAATA -> CACTCGAATAG
GCACTGCAGAG -> CACTGCAGAGG
GCACTGCAGTG -> CACTGCAGTGT
GCAGACTCCTA -> CAGACTCCTAT
GCAGAGGTAAG -> CAGAGGTAAGG
GCAGATCAGAC -> CAGATCAGACT
GCAGATCCGCC -> CAGATCCGCCT
GCAGATTGGCA -> CAGATTGGCAA
GCAGATTTAAC -> CAGATTTAACC
GCAGCAAAGAC -> CAGCAAAGACT
GCAGGAGCCAG -> CAGGAGCCAGA
GCAGTAAGTAC -> CAGTAAGTACG
GCAGTGCGTTC -> CAGTGCGTTCG
GCAGTGCTCGC -> CAGTGCTCGCT
GCAGTGTGGCC -> CAGTGTGGCCG
GCAGTTAACGT -> CAGTTAACGTC
GCATAAAGCTG -> CATAAAGCTGA
GCATAACGCGG -> CATAACGCGGA
GCATAGATGTC -> CATAGATGTCT
GCATAGCTGCA -> CATAGCTGCAT
GCATCTAGTGT -> CATCTAGTGTG
GCATGCAGCAA -> CATGCAGCAAA
GCATGCCTTGG -> CATGCCTTGGC
GCATTGACGTT -> CATTGACGTTG
GCATTTGGTAA -> CATTTGGTAAC
GCCAATGGAGT -> CCAATGGAGTA
GCCACCATGTC -> CCACCATGTCC
GCCAGACCCGT -> CCAGACCCGTA
GCCAGTCTGGA -> CCAGTCTGGAA
GCCCAGGTATT -> CCCAGGTATTT
GCCCCCAACAC -> CCCCCAACACT
GCCCCCTTGCG -> CCCCCTTGCGG
GCCCCTAAGCC -> CCCCTAAGCCG
GCCCCTAGCAC -> CCCCTAGCACT
GCCCGCGATGA -> CCCGCGATGAG
GCCCGGAGCAG -> CCCGGAGCAGT
GCCCTGAGTTA -> CCCTGAGTTAT
GCCGATAACAC -> CCGATAACACC
GCCGATCCTGG -> CCGATCCTGGC
GCCGATGGGAA -> CCGATGGGAAG
GCCGGGTACTT -> CCGGGTACTTA
GCCGTACAGTC -> CCGTACAGTCC
GCCGTAGTTAT -> CCGTAGTTATA
GCCGTCAGTGC -> CCGTCAGTGCG
GCCGTGTTGGT -> CCGTGTTGGTA
GCCTAAGGAAT -> CCTAAGGAATT
GCCTACTTACG -> CCTACTTACGG
GCCTATGTCTT -> CCTATGTCTTA
GCCTCAGTACG -> CCTCAGTACGC
GCCTCGGACTG -> CCTCGGACTGT
GCCTGACTTAG -> CCTGACTTAGG
GCCTGCATAGA -> CCTGCATAGAT
GCCTGGTCAAT -> CCTGGTCAATG
GCCTTAAATTG -> CCTTAAATTGT
GCCTTGCATTT -> CCTTGCATTTG
GCCTTGGCTCA -> CCTTGGCTCAG
GCGAAGATCGT -> CGAAGATCGTA
GCGACTGGGCT -> CGACTGGGCTG
GCGAGGTACTT -> CGAGGTACTTA
GCGATGAGCTA -> CGATGAGCTAA
GCGATGATGTT -> CGATGATGTTT
GCGCACACAGC -> CGCACACAGCT
GCGCAGATTGG -> CGCAGATTGGC
GCGCAGTGCGT -> CGCAGTGCGTT
GCGCCAATGGA -> CGCCAATGGAG
GCGCCCTGAGT -> CGCCCTGAGTT
GCGCCTAAGGA -> CGCCTAAGGAA
GCGCCTACTTA -> CGCCTACTTAC
GCGCCTTGCAT -> CGCCTTGCATT
GCGCGCACACA -> CGCGCACACAG
GCGCGCCTACT -> CGCGCCTACTT
GCGGAAGCAGT -> CGGAAGCAGTG
GCGGAAGTCCT -> CGGAAGTCCTT
GCGGACATTAA -> CGGACATTAAA
GCGGAGAACAA -> CGGAGAACAAT
GCGGAGTTCTT -> CGGAGTTCTTA
GCGGGTATGGT -> CGGGTATGGTT
GCGGTACAATA -> CGGTACAATAC
GCGGTAGCACA -> CGGTAGCACAT
GCGTATCGCAG -> CGTATCGCAGA
GCGTCAGAGAT -> CGTCAGAGATG
GCGTCGCAGGA -> CGTCGCAGGAG
GCGTGAGAGGA -> CGTGAGAGGAG
GCGTTCGTGCC -> CGTTCGTGCCC
GCTAACTCGAG -> CTAACTCGAGT
GCTAAGTCGGT -> CTAAGTCGGTC
GCTAAGTTTGT -> CTAAGTTTGTG
GCTAGATAGCA -> CTAGATAGCAT
GCTAGCACTGC -> CTAGCACTGCA
GCTATACGCCG -> CTATACGCCGT
GCTATGCAGAC -> CTATGCAGACT
GCTCACTTAAT -> CTCACTTAATA
GCTCAGCCTCA -> CTCAGCCTCAG
GCTCATCTTCT -> CTCATCTTCTG
GCTCGCTTAAG -> CTCGCTTAAGT
GCTCGTACAGT -> CTCGTACAGTG
GCTCTGTATTC -> CTCTGTATTCC
GCTCTTAAGAT -> CTCTTAAGATT
GCTCTTCAATG -> CTCTTCAATGA
GCTGAGCTGTT -> CTGAGCTGTTT
GCTGAGTCGGA -> CTGAGTCGGAT
GCTGCAGATCC -> CTGCAGATCCG
GCTGCAGATTT -> CTGCAGATTTA
GCTGCATAAAG -> CTGCATAAAGC
GCTGTACGATA -> CTGTACGATAC
GCTGTAGTGGC -> CTGTAGTGGCA
GCTGTTCACCA -> CTGTTCACCAG
GCTGTTTTTCG -> CTGTTTTTCGC
GCTTAAATAAG -> CTTAAATAAGC
GCTTAAGTCGC -> CTTAAGTCGCT
GCTTACGGTCT -> CTTACGGTCTG
GCTTGATACGC -> CTTGATACGCA
GCTTGTCTGGA -> CTTGTCTGGAA
GCTTTCGTCGT -> CTTTCGTCGTA
GCTTTGTCATA -> CTTTGTCATAA
GGAACAAGCCC -> GAACAAGCCCG
GGAACACTCAT -> GAACACTCATG
GGAACATGTTA -> GAACATGTTAT
GGAAGAGACTT -> GAAGAGACTTA
GGAAGCAGTGC -> GAAGCAGTGCT
GGAAGCTGCAG -> GAAGCTGCAGA
GGAAGGGAGGC -> GAAGGGAGGCC
GGAAGTCCTTG -> GAAGTCCTTGC
GGAATCAAAAA -> GAATCAAAAAA
GGAATGTCCAA -> GAATGTCCAAA
GGAATTGCCAC -> GAATTGCCACC
GGAATTGCTAT -> GAATTGCTATA
GGAATTTAGGA -> GAATTTAGGAG
GGACATTAAAT -> GACATTAAATC
GGACGCGGTAC -> GACGCGGTACA
GGACGGAATTG -> GACGGAATTGC
GGACTAGACCT -> GACTAGACCTT
GGACTGTGAAG -> GACTGTGAAGT
GGAGAACAATG -> GAGAACAATGG
GGAGCAGTAAG -> GAGCAGTAAGT
GGAGCCAGACC -> GAGCCAGACCC
GGAGGCCTGCA -> GAGGCCTGCAT
GGAGGTAATTA -> GAGGTAATTAG
GGAGTACTCCT -> GAGTACTCCTG
GGAGTATATGA -> GAGTATATGAG
GGAGTATTGTG -> GAGTATTGTGT
GGAGTTCTTAC -> GAGTTCTTACA
GGATAATAAAC -> GATAATAAACT
GGATCCCCGAA -> GATCCCCGAAG
GGATGCGACTG -> GATGCGACTGG
GGCAACACATG -> GCAACACATGT
GGCAACGACGT -> GCAACGACGTA
GGCAAGGCATA -> GCAAGGCATAG
GGCACACATTC -> GCACACATTCA
GGCACTCGAAT -> GCACTCGAATA
GGCATAGCTGC -> GCATAGCTGCA
GGCCAGTCTGG -> GCCAGTCTGGA
GGCCCCTAAGC -> GCCCCTAAGCC
GGCCGATGGGA -> GCCGATGGGAA
GGCCTGCATAG -> GCCTGCATAGA
GGCCTTAAATT -> GCCTTAAATTG
GGCGGACATTA -> GCGGACATTAA
GGCGGGTATGG -> GCGGGTATGGT
GGCGGTAGCAC -> GCGGTAGCACA
GGCTAGCACTG -> GCTAGCACTGC
GGCTCACTTAA -> GCTCACTTAAT
GGCTCAGCCTC -> GCTCAGCCTCA
GGCTCTTAAGA -> GCTCTTAAGAT
GGCTGCAGATC -> GCTGCAGATCC
GGCTGTACGAT -> GCTGTACGATA
GGCTTACGGTC -> GCTTACGGTCT
GGCTTTGTCAT -> GCTTTGTCATA
GGGAAGAGACT -> GGAAGAGACTT
GGGAAGCTGCA -> GGAAGCTGCAG
GGGACTAGACC -> GGACTAGACCT
GGGAGGCCTGC -> GGAGGCCTGCA
GGGCAAGGCAT -> GGCAAGGCATA
GGGCACTCGAA -> GGCACTCGAAT
GGGCCAGTCTG -> GGCCAGTCTGG
GGGCCTTAAAT -> GGCCTTAAATT
GGGCGGACATT -> GGCGGACATTA
GGGCGGTAGCA -> GGCGGTAGCAC
GGGCTGCAGAT -> GGCTGCAGATC
GGGCTTACGGT -> GGCTTACGGTC
GGGCTTTGTCA -> GGCTTTGTCAT
GGGGACTAGAC -> GGGACTAGACC
GGGGCCAGTCT -> GGGCCAGTCTG
GGGGCCTTAAA -> GGGCCTTAAAT
GGGGCGGACAT -> GGGCGGACATT
GGGGGACTAGA -> GGGGACTAGAC
GGGGTCTCCCA -> GGGTCTCCCAT
GGGGTGGGCAA -> GGGTGGGCAAG
GGGTACTTAAC -> GGTACTTAACC
GGGTATGGTTG -> GGTATGGTTGT
GGGTATGTGTC -> GGTATGTGTCT
GGGTCTCCCAT -> GGTCTCCCATA
GGGTGGGCAAG -> GGTGGGCAAGG
GGGTTATCAAG -> GGTTATCAAGG
GGGTTTCGATC -> GGTTTCGATCT
GGTAAAGCCCC -> GTAAAGCCCCC
GGTAACAAGGG -> GTAACAAGGGG
GGTAACGATGT -> GTAACGATGTT
GGTAAGGGGTG -> GTAAGGGGTGG
GGTAATTAGTG -> GTAATTAGTGT
GGTACAATACT -> GTACAATACTC
GGTACTTAACC -> GTACTTAACCC,GTACTTAACCT
GGTAGAAGACT -> GTAGAAGACTA
GGTAGCACATA -> GTAGCACATAC
GGTAGCGCCTA -> GTAGCGCCTAA
GGTATAGTATC -> GTATAGTATCC
GGTATGCATTG -> GTATGCATTGA
GGTATGGTTGT -> GTATGGTTGTA
GGTATGTGTCT -> GTATGTGTCTG
GGTATTCTGAC -> GTATTCTGACC
GGTATTTTGCC -> GTATTTTGCCT
GGTCAATGCTC -> GTCAATGCTCT
GGTCACTATTT -> GTCACTATTTG
GGTCGAAAGCG -> GTCGAAAGCGT
GGTCTCCCATA -> GTCTCCCATAT
GGTCTGAAACT -> GTCTGAAACTT
GGTCTTCAGCT -> GTCTTCAGCTC
GGTGGGCAAGG -> GTGGGCAAGGC
GGTTATCAAGG -> GTTATCAAGGA
GGTTCCGCTAG -> GTTCCGCTAGA
GGTTGTAGCTA -> GTTGTAGCTAA
GGTTTCGATCT -> GTTTCGATCTT
GGTTTTGAGCT -> GTTTTGAGCTG
GTAAACAACCT -> TAAACAACCTG
GTAAAGCCCCC -> TAAAGCCCCCA
GTAACAAATCA -> TAACAAATCAC
GTAACAAGGGG -> TAACAAGGGGC
GTAACCGGGCT -> TAACCGGGCTT
GTAACGATGTT -> TAACGATGTTC
GTAAGGGGTGG -> TAAGGGGTGGG
GTAAGTACGCC -> TAAGTACGCCC
GTAAGTTTACA -> TAAGTTTACAC
GTAATGAGCGG -> TAATGAGCGGA
GTAATTAGTGT -> TAATTAGTGTG
GTACAATACTC -> TACAATACTCA
GTACAATGCCG -> TACAATGCCGT
GTACAGTCCGG -> TACAGTCCGGT
GTACAGTGATT -> TACAGTGATTT
GTACATGTAAC -> TACATGTAACA
GTACGATACAA -> TACGATACAAC
GTACGCCCCTA -> TACGCCCCTAG
GTACGCTAAGT -> TACGCTAAGTT
GTACGGATCCC -> TACGGATCCCC
GTACTCCTGTT -> TACTCCTGTTG
GTACTGCACCG -> TACTGCACCGG
GTACTTAACCC -> TACTTAACCCC
GTACTTAACCT -> TACTTAACCTA
GTAGAAGACTA -> TAGAAGACTAA
GTAGCACATAC -> TAGCACATACC
GTAGCGCCCTG -> TAGCGCCCTGA
GTAGCGCCTAA -> TAGCGCCTAAG
GTAGCGCCTTG -> TAGCGCCTTGC
GTAGCTAAGTC -> TAGCTAAGTCG
GTAGCTTAAAT -> TAGCTTAAATA
GTAGGAACACT -> TAGGAACACTC
GTAGGGGCGGA -> TAGGGGCGGAC
GTAGTGGCACA -> TAGTGGCACAC
GTAGTTATATA -> TAGTTATATAG
GTATAGTATCC -> TATAGTATCCA
GTATATGAGGG -> TATATGAGGGG
GTATCCAGCCC -> TATCCAGCCCG
GTATCCATCGA -> TATCCATCGAC
GTATCGCAGAT -> TATCGCAGATC
GTATCGGTAAA -> TATCGGTAAAG
GTATGCATTGA -> TATGCATTGAC
GTATGGTTGTA -> TATGGTTGTAG
GTATGTGTCTG -> TATGTGTCTGT
GTATTCCTTGT -> TATTCCTTGTG
GTATTCTGACC -> TATTCTGACCG
GTATTGTGTAC -> TATTGTGTACA
GTATTTTGCCT -> TATTTTGCCTA
GTCAAGAACCG -> TCAAGAACCGG
GTCAATGCTCT -> TCAATGCTCTG
GTCACTATTTG -> TCACTATTTGG
GTCAGAGATGC -> TCAGAGATGCG
GTCAGTGCGAA -> TCAGTGCGAAG
GTCATAACGAG -> TCATAACGAGT
GTCATATACCG -> TCATATACCGA
GTCCAAAGGCC -> TCCAAAGGCCC
GTCCCCGAATG -> TCCCCGAATGC
GTCCGGTTCCG -> TCCGGTTCCGC
GTCCGTGATTT -> TCCGTGATTTG
GTCCTCTATGC -> TCCTCTATGCC
GTCCTTGCTTT -> TCCTTGCTTTC
GTCGAAAGCGT -> TCGAAAGCGTC
GTCGACTGGGT -> TCGACTGGGTT
GTCGATAGATG -> TCGATAGATGT
GTCGCAGGAGC -> TCGCAGGAGCC
GTCGCCGTGTT -> TCGCCGTGTTG
GTCGCTTGTCT -> TCGCTTGTCTG
GTCGGATGCGA -> TCGGATGCGAC
GTCGGTCGAAA -> TCGGTCGAAAG
GTCGTAGCGCC -> TCGTAGCGCCC
GTCTACCGATT -> TCTACCGATTC
GTCTAGGAACA -> TCTAGGAACAA
GTCTCCCATAT -> TCTCCCATATA
GTCTGAAACTT -> TCTGAAACTTG
GTCTGGAACAT -> TCTGGAACATG
GTCTGGAATCA -> TCTGGAATCAA
GTCTGTTATCG -> TCTGTTATCGT
GTCTTAATACA -> TCTTAATACAC
GTCTTCAGCTC -> TCTTCAGCTCT
GTGAAGTTCAT -> TGAAGTTCATA
GTGAATGTCCT -> TGAATGTCCTC
GTGACCCGTAG -> TGACCCGTAGG
GTGACCGAGTT -> TGACCGAGTTG
GTGAGAGGAGT -> TGAGAGGAGTA
GTGAGTCGATA -> TGAGTCGATAG
GTGATTTCATG -> TGATTTCATGT
GTGATTTGACA -> TGATTTGACAA
GTGATTTTTTA -> TGATTTTTTAT
GTGCCCCCTTG -> TGCCCCCTTGC
GTGCCGATCCT -> TGCCGATCCTG
GTGCGAAGATC -> TGCGAAGATCG
GTGCGTTCGTG -> TGCGTTCGTGC
GTGCTCGCTTA -> TGCTCGCTTAA
GTGCTCGTACA -> TGCTCGTACAG
GTGGAAGGGAG -> TGGAAGGGAGG
GTGGCACACAT -> TGGCACACATT
GTGGCCGATGG -> TGGCCGATGGG
GTGGCTGTACG -> TGGCTGTACGA
GTGGGCAAGGC -> TGGGCAAGGCA
GTGGGGGACTA -> TGGGGGACTAG
GTGGTAACAAG -> TGGTAACAAGG
GTGGTATGCAT -> TGGTATGCATT
GTGTAATGAGC -> TGTAATGAGCG
GTGTACAATGC -> TGTACAATGCC
GTGTACATGTA -> TGTACATGTAA
GTGTAGCTTAA -> TGTAGCTTAAA
GTGTCTGTTAT -> TGTCTGTTATC
GTGTGAATGTC -> TGTGAATGTCC
GTGTGACCCGT -> TGTGACCCGTA
GTGTGGCCGAT -> TGTGGCCGATG
GTGTGGCTGTA -> TGTGGCTGTAC
GTGTTATCCAG -> TGTTATCCAGC
GTGTTGGTATT -> TGTTGGTATTC
GTTAACGTCTA -> TTAACGTCTAG
GTTAAGGACGG -> TTAAGGACGGA
GTTACACAGCA -> TTACACAGCAC
GTTATATAGCT -> TTATATAGCTA
GTTATCAAGGA -> TTATCAAGGAG
GTTATCCAGCA -> TTATCCAGCAT
GTTATCGTATC -> TTATCGTATCC
GTTATGCTTGA -> TTATGCTTGAT
GTTATTATTGT -> TTATTATTGTT
GTTCAACTCCC -> TTCAACTCCCG
GTTCACCAGTG -> TTCACCAGTGG
GTTCATAGTTT -> TTCATAGTTTT
GTTCATGGAAT -> TTCATGGAATT
GTTCCGCTAGA -> TTCCGCTAGAT
GTTCGTGCCCC -> TTCGTGCCCCC
GTTCTTACACA -> TTCTTACACAG
GTTGCTGAGTC -> TTGCTGAGTCG
GTTGGCTCTTA -> TTGGCTCTTAA
GTTGGTATTCT -> TTGGTATTCTG
GTTGTAACCGG -> TTGTAACCGGG
GTTGTAGCTAA -> TTGTAGCTAAG
GTTGTCAAGAA -> TTGTCAAGAAC
GTTTACACCGC -> TTTACACCGCA
GTTTATGAGCA -> TTTATGAGCAA
GTTTCAGCGCA -> TTTCAGCGCAG
GTTTCCCGAGA -> TTTCCCGAGAG
GTTTCGATCTT -> TTTCGATCTTT
GTTTGTGCTCG -> TTTGTGCTCGT
GTTTTGAGCTG -> TTTTGAGCTGT
GTTTTGGTCTT -> TTTTGGTCTTC
GTTTTTAGTGA -> TTTTTAGTGAG
GTTTTTCGCGA -> TTTTTCGCGAG
TAAACAACCTG -> AAACAACCTGT
TAAACTGGGTT -> AAACTGGGTTA
TAAAGCCCCCA -> AAAGCCCCCAA
TAAAGCTGAGC -> AAAGCTGAGCT
TAAATAAGCGA -> AAATAAGCGAT
TAAATCGTTTT -> AAATCGTTTTG
TAAATTGTGGA -> AAATTGTGGAA
TAACAAATCAC -> AACAAATCACA
TAACAAGGGGC -> AACAAGGGGCC
TAACACCCCGC -> AACACCCCGCG
TAACCAGTGTT -> AACCAGTGTTA
TAACCCCCGGG -> AACCCCCGGGT
TAACCGGGCTT -> AACCGGGCTTT
TAACCTACGGT -> AACCTACGGTA
TAACGAGTAAA -> AACGAGTAAAC
TAACGATGTTC -> AACGATGTTCA
TAACGCGGAAG -> AACGCGGAAGT
TAACGCTCATC -> AACGCTCATCT
TAACGTCTAGG -> AACGTCTAGGA
TAACTCGAGAC -> AACTCGAGACC
TAACTCGAGTA -> AACTCGAGTAG
TAAGATTCCAG -> AAGATTCCAGA
TAAGCCGATAA -> AAGCCGATAAC
TAAGCCGGGTA -> AAGCCGGGTAC
TAAGCGATGAT -> AAGCGATGATG
TAAGGAATTTA -> AAGGAATTTAG
TAAGGACGGAA -> AAGGACGGAAT
TAAGGGGTGGG -> AAGGGGTGGGC
TAAGTACGCCC -> AAGTACGCCCC
TAAGTCGCTTG -> AAGTCGCTTGT
TAAGTCGGTCG -> AAGTCGGTCGA
TAAGTTTACAC -> AAGTTTACACC
TAAGTTTGTGC -> AAGTTTGTGCT
TAATAAACTGG -> AATAAACTGGG
TAATACACCGT -> AATACACCGTC
TAATAGATAAC -> AATAGATAACT
TAATCCATAGT -> AATCCATAGTT
TAATGAGCGGA -> AATGAGCGGAG
TAATTAGTGTG -> AATTAGTGTGA
TAATTCAACCA -> AATTCAACCAG
TACAACGTCGC -> ACAACGTCGCC
TACAATACTCA -> ACAATACTCAA
TACAATGCCGT -> ACAATGCCGTC
TACACAGCACG -> ACACAGCACGC
TACACAGTCCG -> ACACAGTCCGT
TACACCGCATA -> ACACCGCATAA
TACACCGTCAT -> ACACCGTCATA
TACAGTCCGGT -> ACAGTCCGGTT
TACAGTGATTT -> ACAGTGATTTC
TACATGTAACA -> ACATGTAACAA
TACCAGAGCCT -> ACCAGAGCCTG
TACCGACCTCA -> ACCGACCTCAG
TACCGATTCAC -> ACCGATTCACA
TACGAAGGCTA -> ACGAAGGCTAG
TACGATACAAC -> ACGATACAACG
TACGCACAAAG -> ACGCACAAAGG
TACGCCCCTAG -> ACGCCCCTAGC
TACGCCGTAGT -> ACGCCGTAGTT
TACGCTAAGTT -> ACGCTAAGTTT
TACGGATCCCC -> ACGGATCCCCG
TACGGGGTCTC -> ACGGGGTCTCC
TACGGTATAGT -> ACGGTATAGTA
TACGGTCTGAA -> ACGGTCTGAAA
TACTAGCGCGC -> ACTAGCGCGCA
TACTCAAAATG -> ACTCAAAATGA
TACTCCTGTTG -> ACTCCTGTTGT
TACTGCACCGG -> ACTGCACCGGA
TACTTAACCCC -> ACTTAACCCCC
TACTTAACCTA -> ACTTAACCTAC
TACTTACGGGG -> ACTTACGGGGT
TACTTGAGCGT -> ACTTGAGCGTC
TAGAAGACTAA -> AGAAGACTAAT
TAGACCTTTAC -> AGACCTTTACT
TAGATAACTCG -> AGATAACTCGA
TAGATAGCATC -> AGATAGCATCT
TAGATGTCTAC -> AGATGTCTACC
TAGATGTGTGA -> AGATGTGTGAC
TAGCACATACC -> AGCACATACCA
TAGCACTATAT -> AGCACTATATG
TAGCACTGCAG -> AGCACTGCAGT
TAGCATCTAGT -> AGCATCTAGTG
TAGCGCCCTGA -> AGCGCCCTGAG
TAGCGCCTAAG -> AGCGCCTAAGG
TAGCGCCTTGC -> AGCGCCTTGCA
TAGCGCGCACA -> AGCGCGCACAC
TAGCTAAGTCG -> AGCTAAGTCGG
TAGCTATGCAG -> AGCTATGCAGA
TAGCTGCATAA -> AGCTGCATAAA
TAGCTTAAATA -> AGCTTAAATAA
TAGGAACAAGC -> AGGAACAAGCC
TAGGAACACTC -> AGGAACACTCA
TAGGACGCGGT -> AGGACGCGGTA
TAGGAGGTAAT -> AGGAGGTAATT
TAGGGGCGGAC -> AGGGGCGGACA
TAGGTAGCGCC -> AGGTAGCGCCT
TAGGTTTTGAG -> AGGTTTTGAGC
TAGTATCCATC -> AGTATCCATCG
TAGTGAGTCGA -> AGTGAGTCGAT
TAGTGGCACAC -> AGTGGCACACA
TAGTGTGAATG -> AGTGTGAATGT
TAGTGTGGCTG -> AGTGTGGCTGT
TAGTTACACAG -> AGTTACACAGC
TAGTTATATAG -> AGTTATATAGC
TAGTTTTTAGT -> AGTTTTTAGTG
TATAAGCCGAT -> ATAAGCCGATA
TATACCGACCT -> ATACCGACCTC
TATACGCCGTA -> ATACGCCGTAG
TATAGCTATGC -> ATAGCTATGCA
TATAGTATCCA -> ATAGTATCCAT
TATATAGCTAT -> ATATAGCTATG
TATATGAGGGG -> ATATGAGGGGC
TATATGCACTG -> ATATGCACTGC
TATCAAGGAGT -> ATCAAGGAGTA
TATCAGTTTCC -> ATCAGTTTCCC
TATCCAGCATG -> ATCCAGCATGC
TATCCAGCCCG -> ATCCAGCCCGC
TATCCATCGAC -> ATCCATCGACG
TATCGCAGATC -> ATCGCAGATCA
TATCGGTAAAG -> ATCGGTAAAGC
TATCGTATCCA -> ATCGTATCCAG
TATGAGCAACG -> ATGAGCAACGT
TATGAGGGGCC -> ATGAGGGGCCA
TATGCACTGCA -> ATGCACTGCAG
TATGCAGACTC -> ATGCAGACTCC
TATGCATTGAC -> ATGCATTGACG
TATGCCTCGGA -> ATGCCTCGGAC
TATGCTTGATA -> ATGCTTGATAC
TATGGTTGTAG -> ATGGTTGTAGC
TATGTCTTAAT -> ATGTCTTAATA
TATGTGTCTGT -> ATGTGTCTGTT
TATTAGGTAGC -> ATTAGGTAGCG
TATTATTGTTG -> ATTATTGTTGT
TATTCCTTGTG -> ATTCCTTGTGT
TATTCTGACCG -> ATTCTGACCGT
TATTGTGTACA -> ATTGTGTACAA
TATTGTTGTCA -> ATTGTTGTCAA
TATTTGGCTCA -> ATTTGGCTCAC
TATTTTGCCTA -> ATTTTGCCTAT
TCAAAAAAGGG -> CAAAAAAGGGC
TCAAAATGATT -> CAAAATGATTG
TCAACCAGGTC -> CAACCAGGTCA
TCAACTCCCGT -> CAACTCCCGTG
TCAAGAACCGG -> CAAGAACCGGG
TCAAGGAGTAT -> CAAGGAGTATT
TCAATGAGTAT -> CAATGAGTATC
TCAATGCTCTG -> CAATGCTCTGT
TCACAGCCCAG -> CACAGCCCAGG
TCACATTGAAT -> CACATTGAATA
TCACCAGTGGG -> CACCAGTGGGG
TCACTATTTGG -> CACTATTTGGC
TCACTTAATAG -> CACTTAATAGA
TCAGACTCAGA -> CAGACTCAGAT
TCAGAGATGCG -> CAGAGATGCGC
TCAGATCTGCG -> CAGATCTGCGC
TCAGATTTGTG -> CAGATTTGTGT
TCAGCCTCAGT -> CAGCCTCAGTA
TCAGCGCAGTG -> CAGCGCAGTGC
TCAGCTCTTCA -> CAGCTCTTCAA
TCAGTACGCTA -> CAGTACGCTAA
TCAGTGCCGAT -> CAGTGCCGATC
TCAGTGCGAAG -> CAGTGCGAAGA
TCAGTTTCCCG -> CAGTTTCCCGA
TCATAACGAGT -> CATAACGAGTA
TCATAGTTTTT -> CATAGTTTTTA
TCATATACCGA -> CATATACCGAC
TCATCCAGTTC -> CATCCAGTTCA
TCATCTTCTGA -> CATCTTCTGAA
TCATGAAACTT -> CATGAAACTTC
TCATGGAATTG -> CATGGAATTGC
TCATGTCGACT -> CATGTCGACTG
TCCAAAGGCCC -> CCAAAGGCCCC
TCCAATACGAA -> CCAATACGAAG
TCCAGAATCAG -> CCAGAATCAGA
TCCAGCATGCC -> CCAGCATGCCT
TCCAGCCCGCG -> CCAGCCCGCGA
TCCAGTTCAAC -> CCAGTTCAACT
TCCATAGTTAC -> CCATAGTTACA
TCCATCGACGT -> CCATCGACGTT
TCCCATATAAG -> CCCATATAAGC
TCCCCCAGTTA -> CCCCCAGTTAA
TCCCCGAAGCC -> CCCCGAAGCCG
TCCCCGAATGC -> CCCCGAATGCA
TCCCGAGAGAC -> CCCGAGAGACA
TCCCGTGTACA -> CCCGTGTACAT
TCCGCCTGGTC -> CCGCCTGGTCA
TCCGCTAGATA -> CCGCTAGATAG
TCCGGTTCCGC -> CCGGTTCCGCT
TCCGTGATTTG -> CCGTGATTTGA
TCCTATTAGGT -> CCTATTAGGTA
TCCTCTATGCC -> CCTCTATGCCT
TCCTGAACCGC -> CCTGAACCGCG
TCCTGGCGGGT -> CCTGGCGGGTA
TCCTGTTGTAA -> CCTGTTGTAAC
TCCTTGCTTTC -> CCTTGCTTTCG
TCCTTGTGTAG -> CCTTGTGTAGC
TCGAAAGCGTC -> CGAAAGCGTCA
TCGAATAGGAC -> CGAATAGGACG
TCGACGTTTAT -> CGACGTTTATG
TCGACTGGGTT -> CGACTGGGTTT
TCGAGACCGTG -> CGAGACCGTGA
TCGAGTAGGGG -> CGAGTAGGGGC
TCGATAGATGT -> CGATAGATGTG
TCGATCTTTCC -> CGATCTTTCCC
TCGCACCAACC -> CGCACCAACCC
TCGCAGATCAG -> CGCAGATCAGA
TCGCAGGAGCC -> CGCAGGAGCCA
TCGCCGTGTTG -> CGCCGTGTTGG
TCGCGAGGTAC -> CGCGAGGTACT
TCGCTTAAGTC -> CGCTTAAGTCG
TCGCTTGTCTG -> CGCTTGTCTGG
TCGGACTGTGA -> CGGACTGTGAA
TCGGATGCGAC -> CGGATGCGACT
TCGGTAAAGCC -> CGGTAAAGCCC
TCGGTCGAAAG -> CGGTCGAAAGC
TCGTAAGTTTA -> CGTAAGTTTAC
TCGTACAGTGA -> CGTACAGTGAT
TCGTAGCGCCC -> CGTAGCGCCCT
TCGTATCCAGC -> CGTATCCAGCC
TCGTCGTAGCG -> CGTCGTAGCGC
TCGTGCCCCCT -> CGTGCCCCCTT
TCGTTTTGGTC -> CGTTTTGGTCT
TCTACCGATTC -> CTACCGATTCA
TCTAGGAACAA -> CTAGGAACAAG
TCTAGTGTGGC -> CTAGTGTGGCT
TCTATGCCTCG -> CTATGCCTCGG
TCTCCAATACG -> CTCCAATACGA
TCTCCCATATA -> CTCCCATATAA
TCTCGCACCAA -> CTCGCACCAAC
TCTGAAACTTG -> CTGAAACTTGA
TCTGAAGTGGT -> CTGAAGTGGTA
TCTGACCGTGA -> CTGACCGTGAC
TCTGCGCCAAT -> CTGCGCCAATG
TCTGGAACATG -> CTGGAACATGT
TCTGGAATCAA -> CTGGAATCAAA
TCTGGAATGTC -> CTGGAATGTCC
TCTGTATTCCT -> CTGTATTCCTT
TCTGTTATCGT -> CTGTTATCGTA
TCTTAAGATTC -> CTTAAGATTCC
TCTTAATACAC -> CTTAATACACC
TCTTACACAGT -> CTTACACAGTC
TCTTCAATGAG -> CTTCAATGAGT
TCTTCAGCTCT -> CTTCAGCTCTT
TCTTCTGAAGT -> CTTCTGAAGTG
TCTTTCCCCCA -> CTTTCCCCCAG
TGAAACTTCTG -> GAAACTTCTGG
TGAAACTTGAG -> GAAACTTGAGA
TGAACCGCGTG -> GAACCGCGTGA
TGAAGTGGTAT -> GAAGTGGTATG
TGAAGTTCATA -> GAAGTTCATAG
TGAATACTAGC -> GAATACTAGCG
TGAATGTCCTC -> GAATGTCCTCT
TGACAACTGGC -> GACAACTGGCA
TGACCCGTAGG -> GACCCGTAGGA
TGACCGAGTTG -> GACCGAGTTGC
TGACCGTGACC -> GACCGTGACCG
TGACGTTGGCT -> GACGTTGGCTC
TGACTTAGGTT -> GACTTAGGTTT
TGAGAGGAGTA -> GAGAGGAGTAC
TGAGATCCTGA -> GAGATCCTGAA
TGAGCAACGTG -> GAGCAACGTGG
TGAGCATGCAG -> GAGCATGCAGC
TGAGCGGAGAA -> GAGCGGAGAAC
TGAGCGTCGCA -> GAGCGTCGCAG
TGAGCTAACTC -> GAGCTAACTCG
TGAGCTGTAGT -> GAGCTGTAGTG
TGAGCTGTTTT -> GAGCTGTTTTT
TGAGGGGCCAG -> GAGGGGCCAGT
TGAGTATCGGT -> GAGTATCGGTA
TGAGTCGATAG -> GAGTCGATAGA
TGAGTCGGATG -> GAGTCGGATGC
TGAGTTATGCT -> GAGTTATGCTT
TGATACGCACA -> GATACGCACAA
TGATGTTTCAG -> GATGTTTCAGC
TGATTGAGCAT -> GATTGAGCATG
TGATTTCATGT -> GATTTCATGTC
TGATTTGACAA -> GATTTGACAAC
TGATTTTTTAT -> GATTTTTTATC
TGCACCGGATA -> GCACCGGATAA
TGCACTGCAGA -> GCACTGCAGAG
TGCAGACTCCT -> GCAGACTCCTA
TGCAGAGGTAA -> GCAGAGGTAAG
TGCAGATCCGC -> GCAGATCCGCC
TGCAGATTTAA -> GCAGATTTAAC
TGCAGCAAAGA -> GCAGCAAAGAC
TGCAGTGTGGC -> GCAGTGTGGCC
TGCAGTTAACG -> GCAGTTAACGT
TGCATAAAGCT -> GCATAAAGCTG
TGCATAGATGT -> GCATAGATGTC
TGCATTGACGT -> GCATTGACGTT
TGCATTTGGTA -> GCATTTGGTAA
TGCCACCATGT -> GCCACCATGTC
TGCCCCCTTGC -> GCCCCCTTGCG
TGCCGATCCTG -> GCCGATCCTGG
TGCCGTCAGTG -> GCCGTCAGTGC
TGCCTATGTCT -> GCCTATGTCTT
TGCCTCGGACT -> GCCTCGGACTG
TGCCTTGGCTC -> GCCTTGGCTCA
TGCGAAGATCG -> GCGAAGATCGT
TGCGACTGGGC -> GCGACTGGGCT
TGCGCCAATGG -> GCGCCAATGGA
TGCGCGCCTAC -> GCGCGCCTACT
TGCGGAAGCAG -> GCGGAAGCAGT
TGCGTTCGTGC -> GCGTTCGTGCC
TGCTATACGCC -> GCTATACGCCG
TGCTCGCTTAA -> GCTCGCTTAAG
TGCTCGTACAG -> GCTCGTACAGT
TGCTCTGTATT -> GCTCTGTATTC
TGCTGAGTCGG -> GCTGAGTCGGA
TGCTTGATACG -> GCTTGATACGC
TGCTTTCGTCG -> GCTTTCGTCGT
TGGAACATGTT -> GGAACATGTTA
TGGAAGGGAGG -> GGAAGGGAGGC
TGGAATCAAAA -> GGAATCAAAAA
TGGAATGTCCA -> GGAATGTCCAA
TGGAATTGCCA -> GGAATTGCCAC
TGGAGTATATG -> GGAGTATATGA
TGGCAACACAT -> GGCAACACATG
TGGCAACGACG -> GGCAACGACGT
TGGCACACATT -> GGCACACATTC
TGGCCGATGGG -> GGCCGATGGGA
TGGCGGGTATG -> GGCGGGTATGG
TGGCTCACTTA -> GGCTCACTTAA
TGGCTCAGCCT -> GGCTCAGCCTC
TGGCTCTTAAG -> GGCTCTTAAGA
TGGCTGTACGA -> GGCTGTACGAT
TGGGAAGAGAC -> GGGAAGAGACT
TGGGCAAGGCA -> GGGCAAGGCAT
TGGGCTGCAGA -> GGGCTGCAGAT
TGGGCTTACGG -> GGGCTTACGGT
TGGGGGACTAG -> GGGGGACTAGA
TGGGTTATCAA -> GGGTTATCAAG
TGGGTTTCGAT -> GGGTTTCGATC
TGGTAACAAGG -> GGTAACAAGGG
TGGTAACGATG -> GGTAACGATGT
TGGTAGAAGAC -> GGTAGAAGACT
TGGTATGCATT -> GGTATGCATTG
TGGTATTCTGA -> GGTATTCTGAC
TGGTCAATGCT -> GGTCAATGCTC
TGGTCTTCAGC -> GGTCTTCAGCT
TGGTTGTAGCT -> GGTTGTAGCTA
TGTAACAAATC -> GTAACAAATCA
TGTAACCGGGC -> GTAACCGGGCT
TGTAATGAGCG -> GTAATGAGCGG
TGTACAATGCC -> GTACAATGCCG
TGTACATGTAA -> GTACATGTAAC
TGTACGATACA -> GTACGATACAA
TGTACTGCACC -> GTACTGCACCG
TGTAGCTAAGT -> GTAGCTAAGTC
TGTAGCTTAAA -> GTAGCTTAAAT
TGTAGTGGCAC -> GTAGTGGCACA
TGTATTCCTTG -> GTATTCCTTGT
TGTCAAGAACC -> GTCAAGAACCG
TGTCATAACGA -> GTCATAACGAG
TGTCCAAAGGC -> GTCCAAAGGCC
TGTCCCCGAAT -> GTCCCCGAATG
TGTCCTCTATG -> GTCCTCTATGC
TGTCGACTGGG -> GTCGACTGGGT
TGTCTACCGAT -> GTCTACCGATT
TGTCTGGAATC -> GTCTGGAATCA
TGTCTGTTATC -> GTCTGTTATCG
TGTCTTAATAC -> GTCTTAATACA
TGTGAAGTTCA -> GTGAAGTTCAT
TGTGAATGTCC -> GTGAATGTCCT
TGTGACCCGTA -> GTGACCCGTAG
TGTGCTCGTAC -> GTGCTCGTACA
TGTGGAAGGGA -> GTGGAAGGGAG
TGTGGCCGATG -> GTGGCCGATGG
TGTGGCTGTAC -> GTGGCTGTACG
TGTGTAATGAG -> GTGTAATGAGC
TGTGTACAATG -> GTGTACAATGC
TGTGTAGCTTA -> GTGTAGCTTAA
TGTGTCTGTTA -> GTGTCTGTTAT
TGTGTGACCCG -> GTGTGACCCGT
TGTTATCCAGC -> GTTATCCAGCA
TGTTATCGTAT -> GTTATCGTATC
TGTTATTATTG -> GTTATTATTGT
TGTTCACCAGT -> GTTCACCAGTG
TGTTCATGGAA -> GTTCATGGAAT
TGTTGGTATTC -> GTTGGTATTCT
TGTTGTAACCG -> GTTGTAACCGG
TGTTGTCAAGA -> GTTGTCAAGAA
TGTTTCAGCGC -> GTTTCAGCGCA
TGTTTTTCGCG -> GTTTTTCGCGA
TTAAATAAGCG -> TAAATAAGCGA
TTAAATCGTTT -> TAAATCGTTTT
TTAAATTGTGG -> TAAATTGTGGA
TTAACCAGTGT -> TAACCAGTGTT
TTAACCCCCGG -> TAACCCCCGGG
TTAACCTACGG -> TAACCTACGGT
TTAACGCTCAT -> TAACGCTCATC
TTAACGTCTAG -> TAACGTCTAGG
TTAAGATTCCA -> TAAGATTCCAG
TTAAGGACGGA -> TAAGGACGGAA
TTAAGTCGCTT -> TAAGTCGCTTG
TTAATACACCG -> TAATACACCGT
TTAATAGATAA -> TAATAGATAAC
TTAATTCAACC -> TAATTCAACCA
TTACACAGCAC -> TACACAGCACG
TTACACAGTCC -> TACACAGTCCG
TTACACCGCAT -> TACACCGCATA
TTACGGGGTCT -> TACGGGGTCTC
TTACGGTCTGA -> TACGGTCTGAA
TTACTTGAGCG -> TACTTGAGCGT
TTAGGAGGTAA -> TAGGAGGTAAT
TTAGGTAGCGC -> TAGGTAGCGCC
TTAGGTTTTGA -> TAGGTTTTGAG
TTAGTGAGTCG -> TAGTGAGTCGA
TTAGTGTGAAT -> TAGTGTGAATG
TTATATAGCTA -> TATATAGCTAT
TTATCAAGGAG -> TATCAAGGAGT
TTATCAGTTTC -> TATCAGTTTCC
TTATCCAGCAT -> TATCCAGCATG
TTATCGTATCC -> TATCGTATCCA
TTATGAGCAAC -> TATGAGCAACG
TTATGCTTGAT -> TATGCTTGATA
TTATTATTGTT -> TATTATTGTTG
TTATTGTTGTC -> TATTGTTGTCA
TTCAACCAGGT -> TCAACCAGGTC
TTCAACTCCCG -> TCAACTCCCGT
TTCAATGAGTA -> TCAATGAGTAT
TTCACAGCCCA -> TCACAGCCCAG
TTCACCAGTGG -> TCACCAGTGGG
TTCAGCGCAGT -> TCAGCGCAGTG
TTCAGCTCTTC -> TCAGCTCTTCA
TTCATAGTTTT -> TCATAGTTTTT
TTCATCCAGTT -> TCATCCAGTTC
TTCATGGAATT -> TCATGGAATTG
TTCATGTCGAC -> TCATGTCGACT
TTCCAGAATCA -> TCCAGAATCAG
TTCCCCCAGTT -> TCCCCCAGTTA
TTCCCGAGAGA -> TCCCGAGAGAC
TTCCGCTAGAT -> TCCGCTAGATA
TTCCTTGTGTA -> TCCTTGTGTAG
TTCGATCTTTC -> TCGATCTTTCC
TTCGCGAGGTA -> TCGCGAGGTAC
TTCGTCGTAGC -> TCGTCGTAGCG
TTCGTGCCCCC -> TCGTGCCCCCT
TTCTGAAGTGG -> TCTGAAGTGGT
TTCTGACCGTG -> TCTGACCGTGA
TTCTGGAATGT -> TCTGGAATGTC
TTCTTACACAG -> TCTTACACAGT
TTGAATACTAG -> TGAATACTAGC
TTGACAACTGG -> TGACAACTGGC
TTGACGTTGGC -> TGACGTTGGCT
TTGAGATCCTG -> TGAGATCCTGA
TTGAGCATGCA -> TGAGCATGCAG
TTGAGCGTCGC -> TGAGCGTCGCA
TTGAGCTGTAG -> TGAGCTGTAGT
TTGATACGCAC -> TGATACGCACA
TTGCATTTGGT -> TGCATTTGGTA
TTGCCACCATG -> TGCCACCATGT
TTGCCTATGTC -> TGCCTATGTCT
TTGCGGAAGCA -> TGCGGAAGCAG
TTGCTATACGC -> TGCTATACGCC
TTGCTGAGTCG -> TGCTGAGTCGG
TTGCTTTCGTC -> TGCTTTCGTCG
TTGGCAACACA -> TGGCAACACAT
TTGGCTCACTT -> TGGCTCACTTA
TTGGCTCAGCC -> TGGCTCAGCCT
TTGGCTCTTAA -> TGGCTCTTAAG
TTGGTAACGAT -> TGGTAACGATG
TTGGTATTCTG -> TGGTATTCTGA
TTGGTCTTCAG -> TGGTCTTCAGC
TTGTAACCGGG -> TGTAACCGGGC
TTGTAGCTAAG -> TGTAGCTAAGT
TTGTCAAGAAC -> TGTCAAGAACC
TTGTCATAACG -> TGTCATAACGA
TTGTCTGGAAT -> TGTCTGGAATC
TTGTGCTCGTA -> TGTGCTCGTAC
TTGTGGAAGGG -> TGTGGAAGGGA
TTGTGTAATGA -> TGTGTAATGAG
TTGTGTACAAT -> TGTGTACAATG
TTGTGTAGCTT -> TGTGTAGCTTA
TTGTTGTCAAG -> TGTTGTCAAGA
TTTAACCAGTG -> TTAACCAGTGT
TTTAACGCTCA -> TTAACGCTCAT
TTTACACCGCA -> TTACACCGCAT
TTTACTTGAGC -> TTACTTGAGCG
TTTAGGAGGTA -> TTAGGAGGTAA
TTTAGTGAGTC -> TTAGTGAGTCG
TTTATCAGTTT -> TTATCAGTTTC
TTTATGAGCAA -> TTATGAGCAAC
TTTCAGCGCAG -> TTCAGCGCAGT
TTTCATGTCGA -> TTCATGTCGAC
TTTCCCCCAGT -> TTCCCCCAGTT
TTTCCCGAGAG -> TTCCCGAGAGA
TTTCGATCTTT -> TTCGATCTTTC
TTTCGCGAGGT -> TTCGCGAGGTA
TTTCGTCGTAG -> TTCGTCGTAGC
TTTGACAACTG -> TTGACAACTGG
TTTGAGCTGTA -> TTGAGCTGTAG
TTTGCCTATGT -> TTGCCTATGTC
TTTGGCTCACT -> TTGGCTCACTT
TTTGGTAACGA -> TTGGTAACGAT
TTTGGTCTTCA -> TTGGTCTTCAG
TTTGTCATAAC -> TTGTCATAACG
TTTGTGCTCGT -> TTGTGCTCGTA
TTTGTGTAATG -> TTGTGTAATGA
TTTTAGTGAGT -> TTTAGTGAGTC
TTTTATCAGTT -> TTTATCAGTTT
TTTTCGCGAGG -> TTTCGCGAGGT
TTTTGAGCTGT -> TTTGAGCTGTA
TTTTGCCTATG -> TTTGCCTATGT
TTTTGGTCTTC -> TTTGGTCTTCA
TTTTTAGTGAG -> TTTTAGTGAGT
TTTTTATCAGT -> TTTTATCAGTT
TTTTTCGCGAG -> TTTTCGCGAGG
TTTTTTATCAG -> TTTTTATCAGT
