CTACTGAGAACCGGGGCAGTGGAG -> TACTGAGAACCGGGGCAGTGGAGG
ATCTCGTCGTCGGTCGCGTACTGA -> TCTCGTCGTCGGTCGCGTACTGAC
GTAGCATGATGTGACTTATGCCCA -> TAGCATGATGTGACTTATGCCCAA
TCCACAAGCTGGGGTGTGCATCGC -> CCACAAGCTGGGGTGTGCATCGCC
TCCTCGCGCAGGTAGCATGATGTG -> CCTCGCGCAGGTAGCATGATGTGA
AACTCTGAAGCTCCAAACGTACTT -> ACTCTGAAGCTCCAAACGTACTTT
TTAGTTCCGCAGTCTCGCTGGACC -> TAGTTCCGCAGTCTCGCTGGACCC
TAGTTGGGGTGACATATCAGTGTT -> AGTTGGGGTGACATATCAGTGTTT
TCATTATAAAAGGTATCCGACGTA -> CATTATAAAAGGTATCCGACGTAT
GCTCCAAACGTACTTTACCCCGCA -> CTCCAAACGTACTTTACCCCGCAG
GCTATGAACAACATATAGATATTG -> CTATGAACAACATATAGATATTGA
GTGCCGTTCGGAAGTCTCTGGGGG -> TGCCGTTCGGAAGTCTCTGGGGGT
CACCGCAACGAAACACAATACCGC -> ACCGCAACGAAACACAATACCGCC
AATTGGCCATGTCCGTATTTTCAC -> ATTGGCCATGTCCGTATTTTCACT
TCGGTGGTAAAAGGATCGGGACCG -> CGGTGGTAAAAGGATCGGGACCGA
TGCCCCGAGCCTAGTCACGGCAAA -> GCCCCGAGCCTAGTCACGGCAAAA
GGCAAAAGTTGAAACACAGACTGC -> GCAAAAGTTGAAACACAGACTGCA
TCGGATTACGGCACAGAAGAGTAG -> CGGATTACGGCACAGAAGAGTAGT
CTTCCTCTTGGGTCGTCTGAACTA -> TTCCTCTTGGGTCGTCTGAACTAC
TCCATCGAGAAATCATACGGTTCT -> CCATCGAGAAATCATACGGTTCTA
CCAGAACCAATTTGCACTCCTAGC -> CAGAACCAATTTGCACTCCTAGCC
CGACGCGTAAATACCCGGTACACC -> GACGCGTAAATACCCGGTACACCC
AGCGCATTGGACGCTGATTTCGCT -> GCGCATTGGACGCTGATTTCGCTT
TACCCGGTTTTCCATCGAGAAATC -> ACCCGGTTTTCCATCGAGAAATCA
CGGCTGTTAGCTCAACCTGCGCAG -> GGCTGTTAGCTCAACCTGCGCAGG
GGGTCGTCTGAACTACTGAGAACC -> GGTCGTCTGAACTACTGAGAACCG
GGCTATGAACAACATATAGATATT -> GCTATGAACAACATATAGATATTG
AGTACCGGTAAACATACTTAGTCA -> GTACCGGTAAACATACTTAGTCAG
GGTTATTACCCGGTTTTCCATCGA -> GTTATTACCCGGTTTTCCATCGAG
GATGTTTGTACGGGTTATTACCCG -> ATGTTTGTACGGGTTATTACCCGG
CCTGGTCTCACAGGCGCTACTTTT -> CTGGTCTCACAGGCGCTACTTTTA
TCCCCTCCAAAGACCATCGAACTC -> CCCCTCCAAAGACCATCGAACTCT
AGGACTATGCTCTTAGGCTGGCTA -> GGACTATGCTCTTAGGCTGGCTAG
TAGGTGCTGTAGTTCCGGCCGAGG -> AGGTGCTGTAGTTCCGGCCGAGGT
ATGATTCCAGAACCAATTTGCACT -> TGATTCCAGAACCAATTTGCACTC
TCGATGTTTGTACGGGTTATTACC -> CGATGTTTGTACGGGTTATTACCC
GTCCCACGCCCAATGGCACTCCTG -> TCCCACGCCCAATGGCACTCCTGG
TGTTTATCTCGTCGTCGGTCGCGT -> GTTTATCTCGTCGTCGGTCGCGTA
TGTCTTGGCGAGCACTTGAAGTAC -> GTCTTGGCGAGCACTTGAAGTACA
CTCTACATTCGTCTTGCCCCGAGC -> TCTACATTCGTCTTGCCCCGAGCC
CTGGTCTCACAGGCGCTACTTTTA -> TGGTCTCACAGGCGCTACTTTTAG
GAGGCCTATAACAACCAATTTAGC -> AGGCCTATAACAACCAATTTAGCC
CCTGCCTTAGCGCAGATCTCACAT -> CTGCCTTAGCGCAGATCTCACATG
CTCAGATCTCGGATTACGGCACAG -> TCAGATCTCGGATTACGGCACAGA
GTGAATAAGGCCTGTTGAATGCTT -> TGAATAAGGCCTGTTGAATGCTTC
ACTGACTCCTTCCTCGCGCAGGTA -> CTGACTCCTTCCTCGCGCAGGTAG
GGCTAGCATGGCCGATCTTTCGAT -> GCTAGCATGGCCGATCTTTCGATA
TTAGCGCAGATCTCACATGCCTTG -> TAGCGCAGATCTCACATGCCTTGT
AACGTACTTTACCCCGCAGGTCGG -> ACGTACTTTACCCCGCAGGTCGGC
GTACATGATTCCAGAACCAATTTG -> TACATGATTCCAGAACCAATTTGC
AATTCGTCCACAAGCTGGGGTGTG -> ATTCGTCCACAAGCTGGGGTGTGC
TAAACATACTTAGTCAGGGGCAAG -> AAACATACTTAGTCAGGGGCAAGT
TGAACAGAGGACTCAGATCTCGGA -> GAACAGAGGACTCAGATCTCGGAT
CTATGAACAACATATAGATATTGA -> TATGAACAACATATAGATATTGAC
CCGCAACGAAACACAATACCGCCG -> CGCAACGAAACACAATACCGCCGA
CGCCCAATGGCACTCCTGGTCTCA -> GCCCAATGGCACTCCTGGTCTCAC
TGACAGCCACCTAGGTCAGGACTA -> GACAGCCACCTAGGTCAGGACTAT
ATCTCACATGCCTTGTCTTGGCGA -> TCTCACATGCCTTGTCTTGGCGAG
CACTCCTAGCCGATACTACGAAGA -> ACTCCTAGCCGATACTACGAAGAG
TCGCGGTCCATCGCTCCGAACGTC -> CGCGGTCCATCGCTCCGAACGTCC
AACGAAGTGGGCCACACCAATTCG -> ACGAAGTGGGCCACACCAATTCGT
TGTCACTTCGAGAATGGCTCCGGT -> GTCACTTCGAGAATGGCTCCGGTT
GATCTCACATGCCTTGTCTTGGCG -> ATCTCACATGCCTTGTCTTGGCGA
GGCTTGATGGCATGTCACTGTAGT -> GCTTGATGGCATGTCACTGTAGTT
CCAAAAGAAGTCCGATGAGAAAAA -> CAAAAGAAGTCCGATGAGAAAAAG
AAGAAGTCCGATGAGAAAAAGTAC -> AGAAGTCCGATGAGAAAAAGTACC
GGTTTCAGCCACTGAACAGAGGAC -> GTTTCAGCCACTGAACAGAGGACT
GCGTTGTGATTAGGACGTGGTACC -> CGTTGTGATTAGGACGTGGTACCC
TTGTGATACTGTCTATGAGTAATC -> TGTGATACTGTCTATGAGTAATCT
ATGATTTGGTCATGGTTCTATTTT -> TGATTTGGTCATGGTTCTATTTTA
CTCGCTGGACCCTTGGCCATAGCC -> TCGCTGGACCCTTGGCCATAGCCG
TTCACTCGATTAATTCGGTGCCTG -> TCACTCGATTAATTCGGTGCCTGC
GGGCGTTGTGATTAGGACGTGGTA -> GGCGTTGTGATTAGGACGTGGTAC
CATGTCACTGTAGTTGGGGTGACA -> ATGTCACTGTAGTTGGGGTGACAT
TGCTTCAGTTAGACCGATCGGCTG -> GCTTCAGTTAGACCGATCGGCTGT
CGGTTTCAGCCACTGAACAGAGGA -> GGTTTCAGCCACTGAACAGAGGAC
CTTGTCTTGGCGAGCACTTGAAGT -> TTGTCTTGGCGAGCACTTGAAGTA
AGCCGTAACTAGCGCATTGGACGC -> GCCGTAACTAGCGCATTGGACGCT
AGAAACTATTAGGCTACGGCTTGA -> GAAACTATTAGGCTACGGCTTGAT
TTGACCCCGTGTCGTACCTGAAAA -> TGACCCCGTGTCGTACCTGAAAAC
CAGACTGCAAGAAAGTCTTACGAG -> AGACTGCAAGAAAGTCTTACGAGA
TGGTCAATGTTCGCGGTCCATCGC -> GGTCAATGTTCGCGGTCCATCGCT
TACCCTCCTCGGAACGTCACGAGA -> ACCCTCCTCGGAACGTCACGAGAA
AGTCTCTGGGGGTATTTATCATGG -> GTCTCTGGGGGTATTTATCATGGG
TGCCGTTCGGAAGTCTCTGGGGGT -> GCCGTTCGGAAGTCTCTGGGGGTA
GGCGAGCACTTGAAGTACATGATT -> GCGAGCACTTGAAGTACATGATTC
CAAAAGAAGTCCGATGAGAAAAAG -> AAAAGAAGTCCGATGAGAAAAAGT
AGAGTTCCATTGTCGCTCGTAAGG -> GAGTTCCATTGTCGCTCGTAAGGT
GCAAGAAAGTCTTACGAGAAACTA -> CAAGAAAGTCTTACGAGAAACTAT
CGCTACTTTTAGTCATAGGGTTCT -> GCTACTTTTAGTCATAGGGTTCTC
ATTCGTCTTGCCCCGAGCCTAGTC -> TTCGTCTTGCCCCGAGCCTAGTCA
CTGCGGGGGTTCTGATATGATTTG -> TGCGGGGGTTCTGATATGATTTGG
ATGGCATGTCACTGTAGTTGGGGT -> TGGCATGTCACTGTAGTTGGGGTG
AGTTCCGGCCGAGGTCGGTGGTAA -> GTTCCGGCCGAGGTCGGTGGTAAA
ACTGCGTCCCACGCCCAATGGCAC -> CTGCGTCCCACGCCCAATGGCACT
ATATAGATATTGACTATTGTCCCC -> TATAGATATTGACTATTGTCCCCA
ACCTGAAAACTAATATCCGGTGTA -> CCTGAAAACTAATATCCGGTGTAA
ACCGAAACGGGGCGTTGTGATTAG -> CCGAAACGGGGCGTTGTGATTAGG
AACCGGGGCAGTGGAGGCCTATAA -> ACCGGGGCAGTGGAGGCCTATAAC
CCGAACGTCCATCAACCCTCGATG -> CGAACGTCCATCAACCCTCGATGT
AAGACAAGTCTGGGTATGGGGGGA -> AGACAAGTCTGGGTATGGGGGGAA
ACCGCCGATTGTTTACATACTGCG -> CCGCCGATTGTTTACATACTGCGT
TCTTGGCGAGCACTTGAAGTACAT -> CTTGGCGAGCACTTGAAGTACATG
ATTAATTCGGTGCCTGCCTTAGCG -> TTAATTCGGTGCCTGCCTTAGCGC
TAACAACCAATTTAGCCCGCTATC -> AACAACCAATTTAGCCCGCTATCA
CAACCCTCGATGTTTGTACGGGTT -> AACCCTCGATGTTTGTACGGGTTA
CCTTCCTCTTGGGTCGTCTGAACT -> CTTCCTCTTGGGTCGTCTGAACTA
GACCATGGAGCATTTGCGTTACAC -> ACCATGGAGCATTTGCGTTACACG
CGATACTACGAAGAGAGTTCCATT -> GATACTACGAAGAGAGTTCCATTG
CATGTCCGTATTTTCACTCGATTA -> ATGTCCGTATTTTCACTCGATTAA
TGTTGAATGCTTCAGTTAGACCGA -> GTTGAATGCTTCAGTTAGACCGAT
GTCCGTATTTTCACTCGATTAATT -> TCCGTATTTTCACTCGATTAATTC
AAGTCTTACGAGAAACTATTAGGC -> AGTCTTACGAGAAACTATTAGGCT
TGAATGCTTCAGTTAGACCGATCG -> GAATGCTTCAGTTAGACCGATCGG
CGCTGGACCCTTGGCCATAGCCGT -> GCTGGACCCTTGGCCATAGCCGTA
GGTACCCTCCTCGGAACGTCACGA -> GTACCCTCCTCGGAACGTCACGAG
ACAGGCGCTACTTTTAGTCATAGG -> CAGGCGCTACTTTTAGTCATAGGG
GTCTCGCTGGACCCTTGGCCATAG -> TCTCGCTGGACCCTTGGCCATAGC
CCAAAGACCATCGAACTCTGAAGC -> CAAAGACCATCGAACTCTGAAGCT
ACGGTTCTATCCAGTATGTCCGAT -> CGGTTCTATCCAGTATGTCCGATT
CCGTCCCCGTATCTTTCGTAAGAG -> CGTCCCCGTATCTTTCGTAAGAGC
TCGCTGATTGGTCGACCGAGATAT -> CGCTGATTGGTCGACCGAGATATC
TCTGCATACGGCTAGCATGGCCGA -> CTGCATACGGCTAGCATGGCCGAT
AACACAGACTGCAAGAAAGTCTTA -> ACACAGACTGCAAGAAAGTCTTAC
CAAAAGTTGAAACACAGACTGCAA -> AAAAGTTGAAACACAGACTGCAAG
CTTGGCGAGCACTTGAAGTACATG -> TTGGCGAGCACTTGAAGTACATGA
CGGGATGCGTGTGCCGTCCCCGTA -> GGGATGCGTGTGCCGTCCCCGTAT
AATGTTCGCGGTCCATCGCTCCGA -> ATGTTCGCGGTCCATCGCTCCGAA
ACATTCGTCTTGCCCCGAGCCTAG -> CATTCGTCTTGCCCCGAGCCTAGT
AGGCTACGGCTTGATGGCATGTCA -> GGCTACGGCTTGATGGCATGTCAC
ACGTATGAATTGGCCATGTCCGTA -> CGTATGAATTGGCCATGTCCGTAT
TTCGTCTTGCCCCGAGCCTAGTCA -> TCGTCTTGCCCCGAGCCTAGTCAC
GGCCTGTTGAATGCTTCAGTTAGA -> GCCTGTTGAATGCTTCAGTTAGAC
GGCCGAGGTCGGTGGTAAAAGGAT -> GCCGAGGTCGGTGGTAAAAGGATC
TTGTACGGGTTATTACCCGGTTTT -> TGTACGGGTTATTACCCGGTTTTC
AGGTATCCGACGTATCCCAAAAGA -> GGTATCCGACGTATCCCAAAAGAA
GGCAAGTCACACAAATGCTATAGA -> GCAAGTCACACAAATGCTATAGAA
CGCGTCTGCATACGGCTAGCATGG -> GCGTCTGCATACGGCTAGCATGGC
GTGGTACCCTCCTCGGAACGTCAC -> TGGTACCCTCCTCGGAACGTCACG
CAGGGGCAAGTCACACAAATGCTA -> AGGGGCAAGTCACACAAATGCTAT
CAATGTTCGCGGTCCATCGCTCCG -> AATGTTCGCGGTCCATCGCTCCGA
ATAAAAGGTATCCGACGTATCCCA -> TAAAAGGTATCCGACGTATCCCAA
CAAAGACCATCGAACTCTGAAGCT -> AAAGACCATCGAACTCTGAAGCTC
AGTTCCGCAGTCTCGCTGGACCCT -> GTTCCGCAGTCTCGCTGGACCCTT
AAGTCACACAAATGCTATAGAACC -> AGTCACACAAATGCTATAGAACCC
GTCCACAAGCTGGGGTGTGCATCG -> TCCACAAGCTGGGGTGTGCATCGC
TAGCCGTAACTAGCGCATTGGACG -> AGCCGTAACTAGCGCATTGGACGC
CATATCAGTGTTTATCTCGTCGTC -> ATATCAGTGTTTATCTCGTCGTCG
TAGGTCAACCCTAGGTGCTGTAGT -> AGGTCAACCCTAGGTGCTGTAGTT
GACAGCCACCTAGGTCAGGACTAT -> ACAGCCACCTAGGTCAGGACTATG
CAGTATGTCCGATTTGTCACTTCG -> AGTATGTCCGATTTGTCACTTCGA
GGATTACGGCACAGAAGAGTAGTC -> GATTACGGCACAGAAGAGTAGTCC
AACTAGCGCATTGGACGCTGATTT -> ACTAGCGCATTGGACGCTGATTTC
TGGTACCCTCCTCGGAACGTCACG -> GGTACCCTCCTCGGAACGTCACGA
CTATAGGTCAACCCTAGGTGCTGT -> TATAGGTCAACCCTAGGTGCTGTA
GCTTCAGTTAGACCGATCGGCTGT -> CTTCAGTTAGACCGATCGGCTGTT
AATCATAATGGAGGACATTGTGCT -> ATCATAATGGAGGACATTGTGCTA
ACGAAGAGAGTTCCATTGTCGCTC -> CGAAGAGAGTTCCATTGTCGCTCG
TCGTAAGGTGATCTGCGGGGGTTC -> CGTAAGGTGATCTGCGGGGGTTCT
GCCGATCTTTCGATATACGGCAGT -> CCGATCTTTCGATATACGGCAGTC
GACACCTGGCAGTATTGAGGCTAT -> ACACCTGGCAGTATTGAGGCTATG
AAATACCCGGTACACCCTTCCTCT -> AATACCCGGTACACCCTTCCTCTT
GTTAGCTCAACCTGCGCAGGACTG -> TTAGCTCAACCTGCGCAGGACTGA
GCATGTCACTGTAGTTGGGGTGAC -> CATGTCACTGTAGTTGGGGTGACA
GTCGTCGGTCGCGTACTGACTCCT -> TCGTCGGTCGCGTACTGACTCCTT
ATTGTGCTACATCATTTCGGATCA -> TTGTGCTACATCATTTCGGATCAC
TAATTCGTGTATGACAGGCAGTTC -> AATTCGTGTATGACAGGCAGTTCC
CCCCGCAGGTCGGCGGATTTGACA -> CCCGCAGGTCGGCGGATTTGACAG
CTCGCGCAGGTAGCATGATGTGAC -> TCGCGCAGGTAGCATGATGTGACT
CCCCGTATCTTTCGTAAGAGCATA -> CCCGTATCTTTCGTAAGAGCATAC
GGCAGTATTGAGGCTATGAACAAC -> GCAGTATTGAGGCTATGAACAACA
GTGGCTGCAGTTTGACCCCGTGTC -> TGGCTGCAGTTTGACCCCGTGTCG
GTCACGGCAAAAGTTGAAACACAG -> TCACGGCAAAAGTTGAAACACAGA
GTCGTACCTGAAAACTAATATCCG -> TCGTACCTGAAAACTAATATCCGG
GGACGTATGAATTGGCCATGTCCG -> GACGTATGAATTGGCCATGTCCGT
CCGGCGCGCGTCTGCATACGGCTA -> CGGCGCGCGTCTGCATACGGCTAG
GGTGATCTGCGGGGGTTCTGATAT -> GTGATCTGCGGGGGTTCTGATATG
TCTCGGATTACGGCACAGAAGAGT -> CTCGGATTACGGCACAGAAGAGTA
CCGACGTATCCCAAAAGAAGTCCG -> CGACGTATCCCAAAAGAAGTCCGA
GCCATGTCCGTATTTTCACTCGAT -> CCATGTCCGTATTTTCACTCGATT
AGGGTTCTCTGCGCTATTGCGCAA -> GGGTTCTCTGCGCTATTGCGCAAT
GAACAGAGGACTCAGATCTCGGAT -> AACAGAGGACTCAGATCTCGGATT
GGTGACTCCTCATTATAAAAGGTA -> GTGACTCCTCATTATAAAAGGTAT
ACTTCGAGAATGGCTCCGGTTTCA -> CTTCGAGAATGGCTCCGGTTTCAG
TTGCACTCCTAGCCGATACTACGA -> TGCACTCCTAGCCGATACTACGAA
ATGCTTCAGTTAGACCGATCGGCT -> TGCTTCAGTTAGACCGATCGGCTG
CTCTTAGGCTGGCTAGATGTACTT -> TCTTAGGCTGGCTAGATGTACTTC
CCCTTCCTCTTGGGTCGTCTGAAC -> CCTTCCTCTTGGGTCGTCTGAACT
TCAGCCACTGAACAGAGGACTCAG -> CAGCCACTGAACAGAGGACTCAGA
CGAGATATCGCTTGTGATACTGTC -> GAGATATCGCTTGTGATACTGTCT
TTTCGCTTGAGTTGACATCCGGGA -> TTCGCTTGAGTTGACATCCGGGAT
TCGCGTACTGACTCCTTCCTCGCG -> CGCGTACTGACTCCTTCCTCGCGC
TGCGTCCCACGCCCAATGGCACTC -> GCGTCCCACGCCCAATGGCACTCC
GTACCCTCCTCGGAACGTCACGAG -> TACCCTCCTCGGAACGTCACGAGA
GGTGGTAAAAGGATCGGGACCGAA -> GTGGTAAAAGGATCGGGACCGAAA
AACACAATACCGCCGATTGTTTAC -> ACACAATACCGCCGATTGTTTACA
AGGTGACTCCTCATTATAAAAGGT -> GGTGACTCCTCATTATAAAAGGTA
ACATATCGACACCTGGCAGTATTG -> CATATCGACACCTGGCAGTATTGA
GCGCAGGTAGCATGATGTGACTTA -> CGCAGGTAGCATGATGTGACTTAT
AGAAAGTCTTACGAGAAACTATTA -> GAAAGTCTTACGAGAAACTATTAG
TTTCGGATCACAGGTGCTACTGCC -> TTCGGATCACAGGTGCTACTGCCG
TATTAGGCTACGGCTTGATGGCAT -> ATTAGGCTACGGCTTGATGGCATG
AACGTCCATCAACCCTCGATGTTT -> ACGTCCATCAACCCTCGATGTTTG
ATAGGGTTCTCTGCGCTATTGCGC -> TAGGGTTCTCTGCGCTATTGCGCA
GATGAGAAAAAGTACCGGTAAACA -> ATGAGAAAAAGTACCGGTAAACAT
TACCTGAAAACTAATATCCGGTGT -> ACCTGAAAACTAATATCCGGTGTA
GGGGGTATTTATCATGGGGTTAGA -> GGGGTATTTATCATGGGGTTAGAT
TCTCGTCGTCGGTCGCGTACTGAC -> CTCGTCGTCGGTCGCGTACTGACT
CCAATTTAGCCCGCTATCAGGTGA -> CAATTTAGCCCGCTATCAGGTGAC
GATTACGGCACAGAAGAGTAGTCC -> ATTACGGCACAGAAGAGTAGTCCC
GGTAGCATGATGTGACTTATGCCC -> GTAGCATGATGTGACTTATGCCCA
ATTGTCCCCAAAAATGTTGGACAC -> TTGTCCCCAAAAATGTTGGACACT
TCCCCAAAAATGTTGGACACTGCC -> CCCCAAAAATGTTGGACACTGCCC
TTGGGTCGTCTGAACTACTGAGAA -> TGGGTCGTCTGAACTACTGAGAAC
TCTCGCTGGACCCTTGGCCATAGC -> CTCGCTGGACCCTTGGCCATAGCC
CCCCAAAAATGTTGGACACTGCCC -> CCCAAAAATGTTGGACACTGCCCG
CAGACCATGGAGCATTTGCGTTAC -> AGACCATGGAGCATTTGCGTTACA
CGTCCCCGTATCTTTCGTAAGAGC -> GTCCCCGTATCTTTCGTAAGAGCA
CCGAGATATCGCTTGTGATACTGT -> CGAGATATCGCTTGTGATACTGTC
CCACAAGCTGGGGTGTGCATCGCC -> CACAAGCTGGGGTGTGCATCGCCC
CCGGTGCTACATATCGACACCTGG -> CGGTGCTACATATCGACACCTGGC
CACAGGTGCTACTGCCGTCCAGAC -> ACAGGTGCTACTGCCGTCCAGACC
GTCGTCTGAACTACTGAGAACCGG -> TCGTCTGAACTACTGAGAACCGGG
TGCGCAGGACTGAAGACAAGTCTG -> GCGCAGGACTGAAGACAAGTCTGG
GTTCCATTGTCGCTCGTAAGGTGA -> TTCCATTGTCGCTCGTAAGGTGAT
TGTACGGGTTATTACCCGGTTTTC -> GTACGGGTTATTACCCGGTTTTCC
GAACTCTGAAGCTCCAAACGTACT -> AACTCTGAAGCTCCAAACGTACTT
CCCAACTCCGGGGTTTAGATCTAT -> CCAACTCCGGGGTTTAGATCTATA
GTCTTGGCGAGCACTTGAAGTACA -> TCTTGGCGAGCACTTGAAGTACAT
GCTACGGCTTGATGGCATGTCACT -> CTACGGCTTGATGGCATGTCACTG
CTAGGTGCTGTAGTTCCGGCCGAG -> TAGGTGCTGTAGTTCCGGCCGAGG
GTAAATACCCGGTACACCCTTCCT -> TAAATACCCGGTACACCCTTCCTC
TGACATATCAGTGTTTATCTCGTC -> GACATATCAGTGTTTATCTCGTCG
CTGTAGTTCCGGCCGAGGTCGGTG -> TGTAGTTCCGGCCGAGGTCGGTGG
GGACATTGTGCTACATCATTTCGG -> GACATTGTGCTACATCATTTCGGA
GGGGTTCTGATATGATTTGGTCAT -> GGGTTCTGATATGATTTGGTCATG
GTAAACATACTTAGTCAGGGGCAA -> TAAACATACTTAGTCAGGGGCAAG
CGTCACGAGAATGATCATCCAATC -> GTCACGAGAATGATCATCCAATCA
TCGACACCTGGCAGTATTGAGGCT -> CGACACCTGGCAGTATTGAGGCTA
CGAGAAATCATACGGTTCTATCCA -> GAGAAATCATACGGTTCTATCCAG
ATGGCCGATCTTTCGATATACGGC -> TGGCCGATCTTTCGATATACGGCA
ACATTGTGCTACATCATTTCGGAT -> CATTGTGCTACATCATTTCGGATC
AAGAGAGTTCCATTGTCGCTCGTA -> AGAGAGTTCCATTGTCGCTCGTAA
GACAGGCAGTTCCTAGCATGAGGC -> ACAGGCAGTTCCTAGCATGAGGCC
CGCCGATTGTTTACATACTGCGTC -> GCCGATTGTTTACATACTGCGTCC
GCCGTCCAGACCATGGAGCATTTG -> CCGTCCAGACCATGGAGCATTTGC
CCCTAGGTGCTGTAGTTCCGGCCG -> CCTAGGTGCTGTAGTTCCGGCCGA
TTCGATATACGGCAGTCGCAACAC -> TCGATATACGGCAGTCGCAACACC
GCGCATGGCGTTCATATCCGTTCC -> CGCATGGCGTTCATATCCGTTCCG
TATCATGGGGTTAGATCGACTATA -> ATCATGGGGTTAGATCGACTATAG
AGTGTTTATCTCGTCGTCGGTCGC -> GTGTTTATCTCGTCGTCGGTCGCG
GATCGGGACCGAAACGGGGCGTTG -> ATCGGGACCGAAACGGGGCGTTGT
ACCAATTTAGCCCGCTATCAGGTG -> CCAATTTAGCCCGCTATCAGGTGA
TTGAGGCTATGAACAACATATAGA -> TGAGGCTATGAACAACATATAGAT
CAACCTGCGCAGGACTGAAGACAA -> AACCTGCGCAGGACTGAAGACAAG
AAAGAAGTCCGATGAGAAAAAGTA -> AAGAAGTCCGATGAGAAAAAGTAC
CGCTCCGAACGTCCATCAACCCTC -> GCTCCGAACGTCCATCAACCCTCG
CACTCGATTAATTCGGTGCCTGCC -> ACTCGATTAATTCGGTGCCTGCCT
ATAAGGCCTGTTGAATGCTTCAGT -> TAAGGCCTGTTGAATGCTTCAGTT
GCTCAACCTGCGCAGGACTGAAGA -> CTCAACCTGCGCAGGACTGAAGAC
ACGTATCCCAAAAGAAGTCCGATG -> CGTATCCCAAAAGAAGTCCGATGA
GCTGATTTCGCTTGAGTTGACATC -> CTGATTTCGCTTGAGTTGACATCC
TGGCGAGCACTTGAAGTACATGAT -> GGCGAGCACTTGAAGTACATGATT
ACGTCCATCAACCCTCGATGTTTG -> CGTCCATCAACCCTCGATGTTTGT
TAATTCGGTGCCTGCCTTAGCGCA -> AATTCGGTGCCTGCCTTAGCGCAG
TCCTGGTCTCACAGGCGCTACTTT -> CCTGGTCTCACAGGCGCTACTTTT
ACATGCCTTGTCTTGGCGAGCACT -> CATGCCTTGTCTTGGCGAGCACTT
ACCATCGAACTCTGAAGCTCCAAA -> CCATCGAACTCTGAAGCTCCAAAC
TGTGACTTATGCCCAACTCCGGGG -> GTGACTTATGCCCAACTCCGGGGT
AGCTCCAAACGTACTTTACCCCGC -> GCTCCAAACGTACTTTACCCCGCA
TGCAAGAAAGTCTTACGAGAAACT -> GCAAGAAAGTCTTACGAGAAACTA
GGTTTAGATCTATATCGTTAATTC -> GTTTAGATCTATATCGTTAATTCG
CGAAACGGGGCGTTGTGATTAGGA -> GAAACGGGGCGTTGTGATTAGGAC
TTCTATCCAGTATGTCCGATTTGT -> TCTATCCAGTATGTCCGATTTGTC
GGGGTTTAGATCTATATCGTTAAT -> GGGTTTAGATCTATATCGTTAATT
CTCTTGGGTCGTCTGAACTACTGA -> TCTTGGGTCGTCTGAACTACTGAG
AAAACTAATATCCGGTGTAATCAT -> AAACTAATATCCGGTGTAATCATA
GACGCTGATTTCGCTTGAGTTGAC -> ACGCTGATTTCGCTTGAGTTGACA
TATCCGACGTATCCCAAAAGAAGT -> ATCCGACGTATCCCAAAAGAAGTC
CGTTACACGTACCGACCGGTGCTA -> GTTACACGTACCGACCGGTGCTAC
GGTTTTCCATCGAGAAATCATACG -> GTTTTCCATCGAGAAATCATACGG
CCCAATGGCACTCCTGGTCTCACA -> CCAATGGCACTCCTGGTCTCACAG
CCACTGAACAGAGGACTCAGATCT -> CACTGAACAGAGGACTCAGATCTC
GAATGTGAATAAGGCCTGTTGAAT -> AATGTGAATAAGGCCTGTTGAATG
ATACGGTTCTATCCAGTATGTCCG -> TACGGTTCTATCCAGTATGTCCGA
TTTGACAGCCACCTAGGTCAGGAC -> TTGACAGCCACCTAGGTCAGGACT
GCTGGCTAGATGTACTTCGCGCAT -> CTGGCTAGATGTACTTCGCGCATG
CGTCTTGCCCCGAGCCTAGTCACG -> GTCTTGCCCCGAGCCTAGTCACGG
TCCGTATTTTCACTCGATTAATTC -> CCGTATTTTCACTCGATTAATTCG
TACTTTTAGTCATAGGGTTCTCTG -> ACTTTTAGTCATAGGGTTCTCTGC
CCGCAGGTCGGCGGATTTGACAGC -> CGCAGGTCGGCGGATTTGACAGCC
GATGCGTGTGCCGTCCCCGTATCT -> ATGCGTGTGCCGTCCCCGTATCTT
AGCATTTGCGTTACACGTACCGAC -> GCATTTGCGTTACACGTACCGACC
CATCGAACTCTGAAGCTCCAAACG -> ATCGAACTCTGAAGCTCCAAACGT
TCCGACTTCTCAACTATCCACTGT -> CCGACTTCTCAACTATCCACTGTG
CAACCCTAGGTGCTGTAGTTCCGG -> AACCCTAGGTGCTGTAGTTCCGGC
CTATTTTAGTTCCGCAGTCTCGCT -> TATTTTAGTTCCGCAGTCTCGCTG
GGCCATAGCCGTAACTAGCGCATT -> GCCATAGCCGTAACTAGCGCATTG
TATCGTTAATTCGTGTATGACAGG -> ATCGTTAATTCGTGTATGACAGGC
TAGCCGATACTACGAAGAGAGTTC -> AGCCGATACTACGAAGAGAGTTCC
ACCTGCGCAGGACTGAAGACAAGT -> CCTGCGCAGGACTGAAGACAAGTC
ACCGGTAAACATACTTAGTCAGGG -> CCGGTAAACATACTTAGTCAGGGG
GCACTCCTGGTCTCACAGGCGCTA -> CACTCCTGGTCTCACAGGCGCTAC
GAAACACAGACTGCAAGAAAGTCT -> AAACACAGACTGCAAGAAAGTCTT
CCGCAGTCTCGCTGGACCCTTGGC -> CGCAGTCTCGCTGGACCCTTGGCC
CCCGGCGCGCGTCTGCATACGGCT -> CCGGCGCGCGTCTGCATACGGCTA
TTTGTACGGGTTATTACCCGGTTT -> TTGTACGGGTTATTACCCGGTTTT
GTCTGCATACGGCTAGCATGGCCG -> TCTGCATACGGCTAGCATGGCCGA
TGGCAGTATTGAGGCTATGAACAA -> GGCAGTATTGAGGCTATGAACAAC
GGCACAGAAGAGTAGTCCCCTCCA -> GCACAGAAGAGTAGTCCCCTCCAA
TTCCTCGCGCAGGTAGCATGATGT -> TCCTCGCGCAGGTAGCATGATGTG
GGTGCTACTGCCGTCCAGACCATG -> GTGCTACTGCCGTCCAGACCATGG
CGATCTTTCGATATACGGCAGTCG -> GATCTTTCGATATACGGCAGTCGC
GGACTATGCTCTTAGGCTGGCTAG -> GACTATGCTCTTAGGCTGGCTAGA
TCAACCTGCGCAGGACTGAAGACA -> CAACCTGCGCAGGACTGAAGACAA
TTGGTCATGGTTCTATTTTAGTTC -> TGGTCATGGTTCTATTTTAGTTCC
GCAGGACTGAAGACAAGTCTGGGT -> CAGGACTGAAGACAAGTCTGGGTA
GTGTCGTACCTGAAAACTAATATC -> TGTCGTACCTGAAAACTAATATCC
AGAAGTCCGATGAGAAAAAGTACC -> GAAGTCCGATGAGAAAAAGTACCG
TGAGAACCGGGGCAGTGGAGGCCT -> GAGAACCGGGGCAGTGGAGGCCTA
TTAGTCAGGGGCAAGTCACACAAA -> TAGTCAGGGGCAAGTCACACAAAT
ATCATTTCGGATCACAGGTGCTAC -> TCATTTCGGATCACAGGTGCTACT
GGTCAATGTTCGCGGTCCATCGCT -> GTCAATGTTCGCGGTCCATCGCTC
CGATTTGTCACTTCGAGAATGGCT -> GATTTGTCACTTCGAGAATGGCTC
CGCTATTGCGCAATGCTGTGCCGT -> GCTATTGCGCAATGCTGTGCCGTT
TTCGCGGTCCATCGCTCCGAACGT -> TCGCGGTCCATCGCTCCGAACGTC
ATCCGGGATGCGTGTGCCGTCCCC -> TCCGGGATGCGTGTGCCGTCCCCG
CAATTTAGCCCGCTATCAGGTGAC -> AATTTAGCCCGCTATCAGGTGACT
CATCAACCCTCGATGTTTGTACGG -> ATCAACCCTCGATGTTTGTACGGG
CATTGGACGCTGATTTCGCTTGAG -> ATTGGACGCTGATTTCGCTTGAGT
TCTATGAGTAATCTTTACCTCTAC -> CTATGAGTAATCTTTACCTCTACA
TCCAGACCATGGAGCATTTGCGTT -> CCAGACCATGGAGCATTTGCGTTA
GACTGCAAGAAAGTCTTACGAGAA -> ACTGCAAGAAAGTCTTACGAGAAA
GGGGTGACATATCAGTGTTTATCT -> GGGTGACATATCAGTGTTTATCTC
TATCCACTGTGTCACTGAACTCGC -> ATCCACTGTGTCACTGAACTCGCT
CGTAACTAGCGCATTGGACGCTGA -> GTAACTAGCGCATTGGACGCTGAT
CATGAGGCCGCGTGGCTGCAGTTT -> ATGAGGCCGCGTGGCTGCAGTTTG
ATACTACGAAGAGAGTTCCATTGT -> TACTACGAAGAGAGTTCCATTGTC
TATTTTCACTCGATTAATTCGGTG -> ATTTTCACTCGATTAATTCGGTGC
ATATACGGCAGTCGCAACACCGCA -> TATACGGCAGTCGCAACACCGCAA
TGGACCCTTGGCCATAGCCGTAAC -> GGACCCTTGGCCATAGCCGTAACT
GGTATCCGACGTATCCCAAAAGAA -> GTATCCGACGTATCCCAAAAGAAG
GACATCCGGGATGCGTGTGCCGTC -> ACATCCGGGATGCGTGTGCCGTCC
CTCCGAACGTCCATCAACCCTCGA -> TCCGAACGTCCATCAACCCTCGAT
GGCTGTTAGCTCAACCTGCGCAGG -> GCTGTTAGCTCAACCTGCGCAGGA
GTCTGAACTACTGAGAACCGGGGC -> TCTGAACTACTGAGAACCGGGGCA
GAGAATGATCATCCAATCATAATG -> AGAATGATCATCCAATCATAATGG
GGGTTCTCTGCGCTATTGCGCAAT -> GGTTCTCTGCGCTATTGCGCAATG
ATTCGGTGCCTGCCTTAGCGCAGA -> TTCGGTGCCTGCCTTAGCGCAGAT
AAGACCATCGAACTCTGAAGCTCC -> AGACCATCGAACTCTGAAGCTCCA
CAAACGTACTTTACCCCGCAGGTC -> AAACGTACTTTACCCCGCAGGTCG
AAAAGGTATCCGACGTATCCCAAA -> AAAGGTATCCGACGTATCCCAAAA
TGCTACTGCCGTCCAGACCATGGA -> GCTACTGCCGTCCAGACCATGGAG
ATGTACTTCGCGCATGGCGTTCAT -> TGTACTTCGCGCATGGCGTTCATA
TTGAATGCTTCAGTTAGACCGATC -> TGAATGCTTCAGTTAGACCGATCG
TTACCCGGTTTTCCATCGAGAAAT -> TACCCGGTTTTCCATCGAGAAATC
GGGTGTGCATCGCCCAAGGGACGT -> GGTGTGCATCGCCCAAGGGACGTA
CAGGTAGCATGATGTGACTTATGC -> AGGTAGCATGATGTGACTTATGCC
AAGAAAGTCTTACGAGAAACTATT -> AGAAAGTCTTACGAGAAACTATTA
GTCACGAGAATGATCATCCAATCA -> TCACGAGAATGATCATCCAATCAT
ACCGATCGGCTGTTAGCTCAACCT -> CCGATCGGCTGTTAGCTCAACCTG
CAGTTTGACCCCGTGTCGTACCTG -> AGTTTGACCCCGTGTCGTACCTGA
GGTCTCACAGGCGCTACTTTTAGT -> GTCTCACAGGCGCTACTTTTAGTC
TTCATATCCGTTCCGACTTCTCAA -> TCATATCCGTTCCGACTTCTCAAC
GTAGTTGGGGTGACATATCAGTGT -> TAGTTGGGGTGACATATCAGTGTT
GTCTATGAGTAATCTTTACCTCTA -> TCTATGAGTAATCTTTACCTCTAC
CATGGAGCATTTGCGTTACACGTA -> ATGGAGCATTTGCGTTACACGTAC
TGAAAACTAATATCCGGTGTAATC -> GAAAACTAATATCCGGTGTAATCA
GGACTCAGATCTCGGATTACGGCA -> GACTCAGATCTCGGATTACGGCAC
GTCGGTGGTAAAAGGATCGGGACC -> TCGGTGGTAAAAGGATCGGGACCG
GTTTGTACGGGTTATTACCCGGTT -> TTTGTACGGGTTATTACCCGGTTT
GCCACCTAGGTCAGGACTATGCTC -> CCACCTAGGTCAGGACTATGCTCT
TCGTCCACAAGCTGGGGTGTGCAT -> CGTCCACAAGCTGGGGTGTGCATC
CCTAGTCACGGCAAAAGTTGAAAC -> CTAGTCACGGCAAAAGTTGAAACA
TGGCCGATCTTTCGATATACGGCA -> GGCCGATCTTTCGATATACGGCAG
TACGGCTTGATGGCATGTCACTGT -> ACGGCTTGATGGCATGTCACTGTA
TCATGGGGTTAGATCGACTATAGG -> CATGGGGTTAGATCGACTATAGGT
GGCTCCGGTTTCAGCCACTGAACA -> GCTCCGGTTTCAGCCACTGAACAG
ATGCGTGTGCCGTCCCCGTATCTT -> TGCGTGTGCCGTCCCCGTATCTTT
GGGATGCGTGTGCCGTCCCCGTAT -> GGATGCGTGTGCCGTCCCCGTATC
GCGGGGGTTCTGATATGATTTGGT -> CGGGGGTTCTGATATGATTTGGTC
GAAGTGGGCCACACCAATTCGTCC -> AAGTGGGCCACACCAATTCGTCCA
GCGTACTGACTCCTTCCTCGCGCA -> CGTACTGACTCCTTCCTCGCGCAG
GTAAAAGGATCGGGACCGAAACGG -> TAAAAGGATCGGGACCGAAACGGG
ACGAAGTGGGCCACACCAATTCGT -> CGAAGTGGGCCACACCAATTCGTC
ACTTAGTCAGGGGCAAGTCACACA -> CTTAGTCAGGGGCAAGTCACACAA
GAGTAATCTTTACCTCTACATTCG -> AGTAATCTTTACCTCTACATTCGT
GAGGACATTGTGCTACATCATTTC -> AGGACATTGTGCTACATCATTTCG
TGCGCTATTGCGCAATGCTGTGCC -> GCGCTATTGCGCAATGCTGTGCCG
CCGATCTTTCGATATACGGCAGTC -> CGATCTTTCGATATACGGCAGTCG
AATGGCTCCGGTTTCAGCCACTGA -> ATGGCTCCGGTTTCAGCCACTGAA
CGTATCCCAAAAGAAGTCCGATGA -> GTATCCCAAAAGAAGTCCGATGAG
CCTGAAAACTAATATCCGGTGTAA -> CTGAAAACTAATATCCGGTGTAAT
GTGCCGTCCCCGTATCTTTCGTAA -> TGCCGTCCCCGTATCTTTCGTAAG
AACACCGCAACGAAACACAATACC -> ACACCGCAACGAAACACAATACCG
ACAGGTGCTACTGCCGTCCAGACC -> CAGGTGCTACTGCCGTCCAGACCA
CGACTATAGGTCAACCCTAGGTGC -> GACTATAGGTCAACCCTAGGTGCT
GTATCCGACGTATCCCAAAAGAAG -> TATCCGACGTATCCCAAAAGAAGT
ATATCGCTTGTGATACTGTCTATG -> TATCGCTTGTGATACTGTCTATGA
TATGGGGGGAAAATTGGTCAATGT -> ATGGGGGGAAAATTGGTCAATGTT
CTGCGCAGGACTGAAGACAAGTCT -> TGCGCAGGACTGAAGACAAGTCTG
ACAGAAGAGTAGTCCCCTCCAAAG -> CAGAAGAGTAGTCCCCTCCAAAGA
TGACATCCGGGATGCGTGTGCCGT -> GACATCCGGGATGCGTGTGCCGTC
AAGGGACGTATGAATTGGCCATGT -> AGGGACGTATGAATTGGCCATGTC
GGGGCGTTGTGATTAGGACGTGGT -> GGGCGTTGTGATTAGGACGTGGTA
TCCAAAGACCATCGAACTCTGAAG -> CCAAAGACCATCGAACTCTGAAGC
GTCTTGCCCCGAGCCTAGTCACGG -> TCTTGCCCCGAGCCTAGTCACGGC
GCAACGAAACACAATACCGCCGAT -> CAACGAAACACAATACCGCCGATT
CGGTACACCCTTCCTCTTGGGTCG -> GGTACACCCTTCCTCTTGGGTCGT
TTATCATGGGGTTAGATCGACTAT -> TATCATGGGGTTAGATCGACTATA
AACTCCGGGGTTTAGATCTATATC -> ACTCCGGGGTTTAGATCTATATCG
CTTCCTCGCGCAGGTAGCATGATG -> TTCCTCGCGCAGGTAGCATGATGT
TCCTAGCCGATACTACGAAGAGAG -> CCTAGCCGATACTACGAAGAGAGT
ACATGATTCCAGAACCAATTTGCA -> CATGATTCCAGAACCAATTTGCAC
CCCGTGTCGTACCTGAAAACTAAT -> CCGTGTCGTACCTGAAAACTAATA
GGTAAACATACTTAGTCAGGGGCA -> GTAAACATACTTAGTCAGGGGCAA
ATCGGGACCGAAACGGGGCGTTGT -> TCGGGACCGAAACGGGGCGTTGTG
GTCACTGTAGTTGGGGTGACATAT -> TCACTGTAGTTGGGGTGACATATC
TTCCGCAGTCTCGCTGGACCCTTG -> TCCGCAGTCTCGCTGGACCCTTGG
AGAGAGTTCCATTGTCGCTCGTAA -> GAGAGTTCCATTGTCGCTCGTAAG
GTTTGACCCCGTGTCGTACCTGAA -> TTTGACCCCGTGTCGTACCTGAAA
AAGGCCTGTTGAATGCTTCAGTTA -> AGGCCTGTTGAATGCTTCAGTTAG
TGCCGTCCAGACCATGGAGCATTT -> GCCGTCCAGACCATGGAGCATTTG
CATCGCTCCGAACGTCCATCAACC -> ATCGCTCCGAACGTCCATCAACCC
CGGTCCATCGCTCCGAACGTCCAT -> GGTCCATCGCTCCGAACGTCCATC
CGGGGTTTAGATCTATATCGTTAA -> GGGGTTTAGATCTATATCGTTAAT
TGTGCCGTTCGGAAGTCTCTGGGG -> GTGCCGTTCGGAAGTCTCTGGGGG
TAGCTCAACCTGCGCAGGACTGAA -> AGCTCAACCTGCGCAGGACTGAAG
ATTTGGTCATGGTTCTATTTTAGT -> TTTGGTCATGGTTCTATTTTAGTT
TTATAAAAGGTATCCGACGTATCC -> TATAAAAGGTATCCGACGTATCCC
CGTCTGAACTACTGAGAACCGGGG -> GTCTGAACTACTGAGAACCGGGGC
GTATCGACGCGTAAATACCCGGTA -> TATCGACGCGTAAATACCCGGTAC
CAATTTGCACTCCTAGCCGATACT -> AATTTGCACTCCTAGCCGATACTA
CTCCAAAGACCATCGAACTCTGAA -> TCCAAAGACCATCGAACTCTGAAG
CATGATTCCAGAACCAATTTGCAC -> ATGATTCCAGAACCAATTTGCACT
TTCGTGTATGACAGGCAGTTCCTA -> TCGTGTATGACAGGCAGTTCCTAG
CGCCCAAGGGACGTATGAATTGGC -> GCCCAAGGGACGTATGAATTGGCC
GAGGTCGGTGGTAAAAGGATCGGG -> AGGTCGGTGGTAAAAGGATCGGGA
TCTGGGGGTATTTATCATGGGGTT -> CTGGGGGTATTTATCATGGGGTTA
CATATTCCAACCTTTTTCCAATCC -> ATATTCCAACCTTTTTCCAATCCT
CGCTCGTAAGGTGATCTGCGGGGG -> GCTCGTAAGGTGATCTGCGGGGGT
CCGGGGTTTAGATCTATATCGTTA -> CGGGGTTTAGATCTATATCGTTAA
CTAGGTCAGGACTATGCTCTTAGG -> TAGGTCAGGACTATGCTCTTAGGC
CACTTCGAGAATGGCTCCGGTTTC -> ACTTCGAGAATGGCTCCGGTTTCA
GCGTAAATACCCGGTACACCCTTC -> CGTAAATACCCGGTACACCCTTCC
TAGATCGACTATAGGTCAACCCTA -> AGATCGACTATAGGTCAACCCTAG
TGGAGGACATTGTGCTACATCATT -> GGAGGACATTGTGCTACATCATTT
CATTCGTCTTGCCCCGAGCCTAGT -> ATTCGTCTTGCCCCGAGCCTAGTC
AATCTTTACCTCTACATTCGTCTT -> ATCTTTACCTCTACATTCGTCTTG
ATTACCCGGTTTTCCATCGAGAAA -> TTACCCGGTTTTCCATCGAGAAAT
CGACCGGTGCTACATATCGACACC -> GACCGGTGCTACATATCGACACCT
CGATTGTTTACATACTGCGTCCCA -> GATTGTTTACATACTGCGTCCCAC
AGGTGCTGTAGTTCCGGCCGAGGT -> GGTGCTGTAGTTCCGGCCGAGGTC
TATCAGGTGACTCCTCATTATAAA -> ATCAGGTGACTCCTCATTATAAAA
GTTTACATACTGCGTCCCACGCCC -> TTTACATACTGCGTCCCACGCCCA
CATCGCCCAAGGGACGTATGAATT -> ATCGCCCAAGGGACGTATGAATTG
GTCGCGTACTGACTCCTTCCTCGC -> TCGCGTACTGACTCCTTCCTCGCG
GTTATTACCCGGTTTTCCATCGAG -> TTATTACCCGGTTTTCCATCGAGA
GCTACTTTTAGTCATAGGGTTCTC -> CTACTTTTAGTCATAGGGTTCTCT
TAGGCTACGGCTTGATGGCATGTC -> AGGCTACGGCTTGATGGCATGTCA
CGTCGTCGGTCGCGTACTGACTCC -> GTCGTCGGTCGCGTACTGACTCCT
CCAAGGGACGTATGAATTGGCCAT -> CAAGGGACGTATGAATTGGCCATG
CTGAACTACTGAGAACCGGGGCAG -> TGAACTACTGAGAACCGGGGCAGT
CTGCCTTAGCGCAGATCTCACATG -> TGCCTTAGCGCAGATCTCACATGC
TTGACATCCGGGATGCGTGTGCCG -> TGACATCCGGGATGCGTGTGCCGT
AAATGCTATAGAACCCGGCGCGCG -> AATGCTATAGAACCCGGCGCGCGT
CGGATCACAGGTGCTACTGCCGTC -> GGATCACAGGTGCTACTGCCGTCC
GTAATCATATTCCAACCTTTTTCC -> TAATCATATTCCAACCTTTTTCCA
ATGTTTGTACGGGTTATTACCCGG -> TGTTTGTACGGGTTATTACCCGGT
GCAGTTCCTAGCATGAGGCCGCGT -> CAGTTCCTAGCATGAGGCCGCGTG
CTTGGGTCGTCTGAACTACTGAGA -> TTGGGTCGTCTGAACTACTGAGAA
TGCCTTAGCGCAGATCTCACATGC -> GCCTTAGCGCAGATCTCACATGCC
CACTCCTGGTCTCACAGGCGCTAC -> ACTCCTGGTCTCACAGGCGCTACT
TTGCGTTACACGTACCGACCGGTG -> TGCGTTACACGTACCGACCGGTGC
CGCAGGTAGCATGATGTGACTTAT -> GCAGGTAGCATGATGTGACTTATG
GCAAAAGTTGAAACACAGACTGCA -> CAAAAGTTGAAACACAGACTGCAA
CCCCTCCAAAGACCATCGAACTCT -> CCCTCCAAAGACCATCGAACTCTG
TGTCACTGTAGTTGGGGTGACATA -> GTCACTGTAGTTGGGGTGACATAT
AAGTTGAAACACAGACTGCAAGAA -> AGTTGAAACACAGACTGCAAGAAA
CATACCCCTCGCATGTATCGACGC -> ATACCCCTCGCATGTATCGACGCG
CATCGAGAAATCATACGGTTCTAT -> ATCGAGAAATCATACGGTTCTATC
ATCTTTCGTAAGAGCATACCCCTC -> TCTTTCGTAAGAGCATACCCCTCG
CCTGCGCAGGACTGAAGACAAGTC -> CTGCGCAGGACTGAAGACAAGTCT
TCGGGACCGAAACGGGGCGTTGTG -> CGGGACCGAAACGGGGCGTTGTGA
CGTCGGTCGCGTACTGACTCCTTC -> GTCGGTCGCGTACTGACTCCTTCC
GGTCAGGACTATGCTCTTAGGCTG -> GTCAGGACTATGCTCTTAGGCTGG
CAATCCTCAACATCAACGAAGTGG -> AATCCTCAACATCAACGAAGTGGG
GATACTACGAAGAGAGTTCCATTG -> ATACTACGAAGAGAGTTCCATTGT
GATGGCATGTCACTGTAGTTGGGG -> ATGGCATGTCACTGTAGTTGGGGT
CACGGCAAAAGTTGAAACACAGAC -> ACGGCAAAAGTTGAAACACAGACT
TACATTCGTCTTGCCCCGAGCCTA -> ACATTCGTCTTGCCCCGAGCCTAG
CAGTTAGACCGATCGGCTGTTAGC -> AGTTAGACCGATCGGCTGTTAGCT
TAGTCACGGCAAAAGTTGAAACAC -> AGTCACGGCAAAAGTTGAAACACA
CACTGAACTCGCTGATTGGTCGAC -> ACTGAACTCGCTGATTGGTCGACC
GGCGCGCGTCTGCATACGGCTAGC -> GCGCGCGTCTGCATACGGCTAGCA
GACTATTGTCCCCAAAAATGTTGG -> ACTATTGTCCCCAAAAATGTTGGA
GACGTATGAATTGGCCATGTCCGT -> ACGTATGAATTGGCCATGTCCGTA
GCATACGGCTAGCATGGCCGATCT -> CATACGGCTAGCATGGCCGATCTT
TTGTCTTGGCGAGCACTTGAAGTA -> TGTCTTGGCGAGCACTTGAAGTAC
AAGTACATGATTCCAGAACCAATT -> AGTACATGATTCCAGAACCAATTT
TTTATCTCGTCGTCGGTCGCGTAC -> TTATCTCGTCGTCGGTCGCGTACT
TGAAACACAGACTGCAAGAAAGTC -> GAAACACAGACTGCAAGAAAGTCT
TGGGCCACACCAATTCGTCCACAA -> GGGCCACACCAATTCGTCCACAAG
CATTTGCGTTACACGTACCGACCG -> ATTTGCGTTACACGTACCGACCGG
ATAGAACCCGGCGCGCGTCTGCAT -> TAGAACCCGGCGCGCGTCTGCATA
CGAGCACTTGAAGTACATGATTCC -> GAGCACTTGAAGTACATGATTCCA
AAGAGCATACCCCTCGCATGTATC -> AGAGCATACCCCTCGCATGTATCG
TTTACCTCTACATTCGTCTTGCCC -> TTACCTCTACATTCGTCTTGCCCC
AACATACTTAGTCAGGGGCAAGTC -> ACATACTTAGTCAGGGGCAAGTCA
ATCGCTTGTGATACTGTCTATGAG -> TCGCTTGTGATACTGTCTATGAGT
TTGAAGTACATGATTCCAGAACCA -> TGAAGTACATGATTCCAGAACCAA
AACCAATTTAGCCCGCTATCAGGT -> ACCAATTTAGCCCGCTATCAGGTG
TACGGTTCTATCCAGTATGTCCGA -> ACGGTTCTATCCAGTATGTCCGAT
ATGTTGGACACTGCCCGGATGTGA -> TGTTGGACACTGCCCGGATGTGAC
AGGACTGAAGACAAGTCTGGGTAT -> GGACTGAAGACAAGTCTGGGTATG
CAACCTTTTTCCAATCCTCAACAT -> AACCTTTTTCCAATCCTCAACATC
ACAACCAATTTAGCCCGCTATCAG -> CAACCAATTTAGCCCGCTATCAGG
CCGGTGTAATCATATTCCAACCTT -> CGGTGTAATCATATTCCAACCTTT
TGATTCCAGAACCAATTTGCACTC -> GATTCCAGAACCAATTTGCACTCC
TCAGATCTCGGATTACGGCACAGA -> CAGATCTCGGATTACGGCACAGAA
ATTGTCGCTCGTAAGGTGATCTGC -> TTGTCGCTCGTAAGGTGATCTGCG
CAATACCGCCGATTGTTTACATAC -> AATACCGCCGATTGTTTACATACT
AGCATGAGGCCGCGTGGCTGCAGT -> GCATGAGGCCGCGTGGCTGCAGTT
CTCCAAACGTACTTTACCCCGCAG -> TCCAAACGTACTTTACCCCGCAGG
CCGTTCCGACTTCTCAACTATCCA -> CGTTCCGACTTCTCAACTATCCAC
GATTGTTTACATACTGCGTCCCAC -> ATTGTTTACATACTGCGTCCCACG
CCTCCAAAGACCATCGAACTCTGA -> CTCCAAAGACCATCGAACTCTGAA
CGGTGCCTGCCTTAGCGCAGATCT -> GGTGCCTGCCTTAGCGCAGATCTC
ATATTGACTATTGTCCCCAAAAAT -> TATTGACTATTGTCCCCAAAAATG
TATTGCGCAATGCTGTGCCGTTCG -> ATTGCGCAATGCTGTGCCGTTCGG
GAGTTCCATTGTCGCTCGTAAGGT -> AGTTCCATTGTCGCTCGTAAGGTG
TGCTCTTAGGCTGGCTAGATGTAC -> GCTCTTAGGCTGGCTAGATGTACT
GAAATCATACGGTTCTATCCAGTA -> AAATCATACGGTTCTATCCAGTAT
GGGGCAGTGGAGGCCTATAACAAC -> GGGCAGTGGAGGCCTATAACAACC
CACCCTTCCTCTTGGGTCGTCTGA -> ACCCTTCCTCTTGGGTCGTCTGAA
TAGAACCCGGCGCGCGTCTGCATA -> AGAACCCGGCGCGCGTCTGCATAC
GTAGTCCCCTCCAAAGACCATCGA -> TAGTCCCCTCCAAAGACCATCGAA
CCAATTTGCACTCCTAGCCGATAC -> CAATTTGCACTCCTAGCCGATACT
GGTAAAAGGATCGGGACCGAAACG -> GTAAAAGGATCGGGACCGAAACGG
TATATCGTTAATTCGTGTATGACA -> ATATCGTTAATTCGTGTATGACAG
TCATATCCGTTCCGACTTCTCAAC -> CATATCCGTTCCGACTTCTCAACT
ATGCTATAGAACCCGGCGCGCGTC -> TGCTATAGAACCCGGCGCGCGTCT
AAATCATACGGTTCTATCCAGTAT -> AATCATACGGTTCTATCCAGTATG
GTACTGACTCCTTCCTCGCGCAGG -> TACTGACTCCTTCCTCGCGCAGGT
AAAAATGTTGGACACTGCCCGGAT -> AAAATGTTGGACACTGCCCGGATG
ATAACAACCAATTTAGCCCGCTAT -> TAACAACCAATTTAGCCCGCTATC
TCGTGTATGACAGGCAGTTCCTAG -> CGTGTATGACAGGCAGTTCCTAGC
GTGCTGTAGTTCCGGCCGAGGTCG -> TGCTGTAGTTCCGGCCGAGGTCGG
TGGCACTCCTGGTCTCACAGGCGC -> GGCACTCCTGGTCTCACAGGCGCT
AGGTCAACCCTAGGTGCTGTAGTT -> GGTCAACCCTAGGTGCTGTAGTTC
GAAGCTCCAAACGTACTTTACCCC -> AAGCTCCAAACGTACTTTACCCCG
TCCAACCTTTTTCCAATCCTCAAC -> CCAACCTTTTTCCAATCCTCAACA
CATACGGTTCTATCCAGTATGTCC -> ATACGGTTCTATCCAGTATGTCCG
GCCGCGTGGCTGCAGTTTGACCCC -> CCGCGTGGCTGCAGTTTGACCCCG
ACTTTACCCCGCAGGTCGGCGGAT -> CTTTACCCCGCAGGTCGGCGGATT
CCTTCCTCGCGCAGGTAGCATGAT -> CTTCCTCGCGCAGGTAGCATGATG
GGTTCTATCCAGTATGTCCGATTT -> GTTCTATCCAGTATGTCCGATTTG
GATCACAGGTGCTACTGCCGTCCA -> ATCACAGGTGCTACTGCCGTCCAG
CCCAAGGGACGTATGAATTGGCCA -> CCAAGGGACGTATGAATTGGCCAT
ACCTTTTTCCAATCCTCAACATCA -> CCTTTTTCCAATCCTCAACATCAA
CCCCTCGCATGTATCGACGCGTAA -> CCCTCGCATGTATCGACGCGTAAA
GAAAATTGGTCAATGTTCGCGGTC -> AAAATTGGTCAATGTTCGCGGTCC
ATCTTTACCTCTACATTCGTCTTG -> TCTTTACCTCTACATTCGTCTTGC
GGACCCTTGGCCATAGCCGTAACT -> GACCCTTGGCCATAGCCGTAACTA
TATCAGTGTTTATCTCGTCGTCGG -> ATCAGTGTTTATCTCGTCGTCGGT
TATGACAGGCAGTTCCTAGCATGA -> ATGACAGGCAGTTCCTAGCATGAG
CTGTTGAATGCTTCAGTTAGACCG -> TGTTGAATGCTTCAGTTAGACCGA
GATTTGGTCATGGTTCTATTTTAG -> ATTTGGTCATGGTTCTATTTTAGT
ACCGGGGCAGTGGAGGCCTATAAC -> CCGGGGCAGTGGAGGCCTATAACA
CGCAGGACTGAAGACAAGTCTGGG -> GCAGGACTGAAGACAAGTCTGGGT
AGGCCGCGTGGCTGCAGTTTGACC -> GGCCGCGTGGCTGCAGTTTGACCC
TGACAGGCAGTTCCTAGCATGAGG -> GACAGGCAGTTCCTAGCATGAGGC
ATCGACGCGTAAATACCCGGTACA -> TCGACGCGTAAATACCCGGTACAC
AAACGTACTTTACCCCGCAGGTCG -> AACGTACTTTACCCCGCAGGTCGG
CGGCCGAGGTCGGTGGTAAAAGGA -> GGCCGAGGTCGGTGGTAAAAGGAT
AACGTCACGAGAATGATCATCCAA -> ACGTCACGAGAATGATCATCCAAT
CAAGCTGGGGTGTGCATCGCCCAA -> AAGCTGGGGTGTGCATCGCCCAAG
GGTGCTGTAGTTCCGGCCGAGGTC -> GTGCTGTAGTTCCGGCCGAGGTCG
TCGTTAATTCGTGTATGACAGGCA -> CGTTAATTCGTGTATGACAGGCAG
TTCGCTTGAGTTGACATCCGGGAT -> TCGCTTGAGTTGACATCCGGGATG
CCCAAAAATGTTGGACACTGCCCG -> CCAAAAATGTTGGACACTGCCCGG
TGGGGTTAGATCGACTATAGGTCA -> GGGGTTAGATCGACTATAGGTCAA
AGAAAAAGTACCGGTAAACATACT -> GAAAAAGTACCGGTAAACATACTT
CCATTGTCGCTCGTAAGGTGATCT -> CATTGTCGCTCGTAAGGTGATCTG
TGCACTCCTAGCCGATACTACGAA -> GCACTCCTAGCCGATACTACGAAG
AGTTTGACCCCGTGTCGTACCTGA -> GTTTGACCCCGTGTCGTACCTGAA
TGGAGGCCTATAACAACCAATTTA -> GGAGGCCTATAACAACCAATTTAG
ATCATACGGTTCTATCCAGTATGT -> TCATACGGTTCTATCCAGTATGTC
CTGAACAGAGGACTCAGATCTCGG -> TGAACAGAGGACTCAGATCTCGGA
ACTGAGAACCGGGGCAGTGGAGGC -> CTGAGAACCGGGGCAGTGGAGGCC
GGCGTTCATATCCGTTCCGACTTC -> GCGTTCATATCCGTTCCGACTTCT
AATGCTGTGCCGTTCGGAAGTCTC -> ATGCTGTGCCGTTCGGAAGTCTCT
TCGCTTGTGATACTGTCTATGAGT -> CGCTTGTGATACTGTCTATGAGTA
GTCTGGGTATGGGGGGAAAATTGG -> TCTGGGTATGGGGGGAAAATTGGT
CATAGCCGTAACTAGCGCATTGGA -> ATAGCCGTAACTAGCGCATTGGAC
TACATATCGACACCTGGCAGTATT -> ACATATCGACACCTGGCAGTATTG
GCCGTCCCCGTATCTTTCGTAAGA -> CCGTCCCCGTATCTTTCGTAAGAG
GTACCGACCGGTGCTACATATCGA -> TACCGACCGGTGCTACATATCGAC
GAAGAGTAGTCCCCTCCAAAGACC -> AAGAGTAGTCCCCTCCAAAGACCA
CATCATTTCGGATCACAGGTGCTA -> ATCATTTCGGATCACAGGTGCTAC
AGTTGAAACACAGACTGCAAGAAA -> GTTGAAACACAGACTGCAAGAAAG
ATGGAGGACATTGTGCTACATCAT -> TGGAGGACATTGTGCTACATCATT
GGCTGGCTAGATGTACTTCGCGCA -> GCTGGCTAGATGTACTTCGCGCAT
GCACAGAAGAGTAGTCCCCTCCAA -> CACAGAAGAGTAGTCCCCTCCAAA
TTGCGCAATGCTGTGCCGTTCGGA -> TGCGCAATGCTGTGCCGTTCGGAA
CGTGGCTGCAGTTTGACCCCGTGT -> GTGGCTGCAGTTTGACCCCGTGTC
ACTCCTGGTCTCACAGGCGCTACT -> CTCCTGGTCTCACAGGCGCTACTT
TGGTAAAAGGATCGGGACCGAAAC -> GGTAAAAGGATCGGGACCGAAACG
CTTGGCCATAGCCGTAACTAGCGC -> TTGGCCATAGCCGTAACTAGCGCA
CGTCTGCATACGGCTAGCATGGCC -> GTCTGCATACGGCTAGCATGGCCG
CTGGGGTGTGCATCGCCCAAGGGA -> TGGGGTGTGCATCGCCCAAGGGAC
CGCAATGCTGTGCCGTTCGGAAGT -> GCAATGCTGTGCCGTTCGGAAGTC
AACCTGCGCAGGACTGAAGACAAG -> ACCTGCGCAGGACTGAAGACAAGT
CCGGTTTCAGCCACTGAACAGAGG -> CGGTTTCAGCCACTGAACAGAGGA
ATTGCGCAATGCTGTGCCGTTCGG -> TTGCGCAATGCTGTGCCGTTCGGA
GCAGGTCGGCGGATTTGACAGCCA -> CAGGTCGGCGGATTTGACAGCCAC
CGTATCTTTCGTAAGAGCATACCC -> GTATCTTTCGTAAGAGCATACCCC
TATGATTTGGTCATGGTTCTATTT -> ATGATTTGGTCATGGTTCTATTTT
ATTCGTCCACAAGCTGGGGTGTGC -> TTCGTCCACAAGCTGGGGTGTGCA
CAGTCGCAACACCGCAACGAAACA -> AGTCGCAACACCGCAACGAAACAC
GGTCGACCGAGATATCGCTTGTGA -> GTCGACCGAGATATCGCTTGTGAT
CCCGTATCTTTCGTAAGAGCATAC -> CCGTATCTTTCGTAAGAGCATACC
TCTCACATGCCTTGTCTTGGCGAG -> CTCACATGCCTTGTCTTGGCGAGC
TCTATTTTAGTTCCGCAGTCTCGC -> CTATTTTAGTTCCGCAGTCTCGCT
AGAGGACTCAGATCTCGGATTACG -> GAGGACTCAGATCTCGGATTACGG
AGCCGATACTACGAAGAGAGTTCC -> GCCGATACTACGAAGAGAGTTCCA
TATTACCCGGTTTTCCATCGAGAA -> ATTACCCGGTTTTCCATCGAGAAA
TGACTTATGCCCAACTCCGGGGTT -> GACTTATGCCCAACTCCGGGGTTT
GGTCATGGTTCTATTTTAGTTCCG -> GTCATGGTTCTATTTTAGTTCCGC
CGGCGCGCGTCTGCATACGGCTAG -> GGCGCGCGTCTGCATACGGCTAGC
GACTGAAGACAAGTCTGGGTATGG -> ACTGAAGACAAGTCTGGGTATGGG
TTACCCCGCAGGTCGGCGGATTTG -> TACCCCGCAGGTCGGCGGATTTGA
GGGTTAGATCGACTATAGGTCAAC -> GGTTAGATCGACTATAGGTCAACC
TGCCTTGTCTTGGCGAGCACTTGA -> GCCTTGTCTTGGCGAGCACTTGAA
GGGGCAAGTCACACAAATGCTATA -> GGGCAAGTCACACAAATGCTATAG
GGTCGCGTACTGACTCCTTCCTCG -> GTCGCGTACTGACTCCTTCCTCGC
GACATTGTGCTACATCATTTCGGA -> ACATTGTGCTACATCATTTCGGAT
ACTTTTAGTCATAGGGTTCTCTGC -> CTTTTAGTCATAGGGTTCTCTGCG
TTAGTCATAGGGTTCTCTGCGCTA -> TAGTCATAGGGTTCTCTGCGCTAT
ATGAGAAAAAGTACCGGTAAACAT -> TGAGAAAAAGTACCGGTAAACATA
CTATGAGTAATCTTTACCTCTACA -> TATGAGTAATCTTTACCTCTACAT
AGCATACCCCTCGCATGTATCGAC -> GCATACCCCTCGCATGTATCGACG
AAGTACCGGTAAACATACTTAGTC -> AGTACCGGTAAACATACTTAGTCA
TCTGATATGATTTGGTCATGGTTC -> CTGATATGATTTGGTCATGGTTCT
AACCCGGCGCGCGTCTGCATACGG -> ACCCGGCGCGCGTCTGCATACGGC
TTGGGGTGACATATCAGTGTTTAT -> TGGGGTGACATATCAGTGTTTATC
ATACTGTCTATGAGTAATCTTTAC -> TACTGTCTATGAGTAATCTTTACC
TGTAGTTGGGGTGACATATCAGTG -> GTAGTTGGGGTGACATATCAGTGT
GCGCATTGGACGCTGATTTCGCTT -> CGCATTGGACGCTGATTTCGCTTG
GTCATAGGGTTCTCTGCGCTATTG -> TCATAGGGTTCTCTGCGCTATTGC
ACGGGGCGTTGTGATTAGGACGTG -> CGGGGCGTTGTGATTAGGACGTGG
GTAACTAGCGCATTGGACGCTGAT -> TAACTAGCGCATTGGACGCTGATT
TCCAGAACCAATTTGCACTCCTAG -> CCAGAACCAATTTGCACTCCTAGC
TGCCGTCCCCGTATCTTTCGTAAG -> GCCGTCCCCGTATCTTTCGTAAGA
GAGATATCGCTTGTGATACTGTCT -> AGATATCGCTTGTGATACTGTCTA
TCGGAACGTCACGAGAATGATCAT -> CGGAACGTCACGAGAATGATCATC
ACTGAAGACAAGTCTGGGTATGGG -> CTGAAGACAAGTCTGGGTATGGGG
CCTTGGCCATAGCCGTAACTAGCG -> CTTGGCCATAGCCGTAACTAGCGC
CTATAACAACCAATTTAGCCCGCT -> TATAACAACCAATTTAGCCCGCTA
AAGTCTGGGTATGGGGGGAAAATT -> AGTCTGGGTATGGGGGGAAAATTG
TCCGGTGTAATCATATTCCAACCT -> CCGGTGTAATCATATTCCAACCTT
ACCCCGCAGGTCGGCGGATTTGAC -> CCCCGCAGGTCGGCGGATTTGACA
CTCAACTATCCACTGTGTCACTGA -> TCAACTATCCACTGTGTCACTGAA
TGAGGCTATGAACAACATATAGAT -> GAGGCTATGAACAACATATAGATA
TCCAATCATAATGGAGGACATTGT -> CCAATCATAATGGAGGACATTGTG
ACTAATATCCGGTGTAATCATATT -> CTAATATCCGGTGTAATCATATTC
GACTTCTCAACTATCCACTGTGTC -> ACTTCTCAACTATCCACTGTGTCA
CGTAAGGTGATCTGCGGGGGTTCT -> GTAAGGTGATCTGCGGGGGTTCTG
TACTGCGTCCCACGCCCAATGGCA -> ACTGCGTCCCACGCCCAATGGCAC
TTTTTCCAATCCTCAACATCAACG -> TTTTCCAATCCTCAACATCAACGA
TTGTCCCCAAAAATGTTGGACACT -> TGTCCCCAAAAATGTTGGACACTG
GCATACCCCTCGCATGTATCGACG -> CATACCCCTCGCATGTATCGACGC
CTCTGGGGGTATTTATCATGGGGT -> TCTGGGGGTATTTATCATGGGGTT
AAGTCTCTGGGGGTATTTATCATG -> AGTCTCTGGGGGTATTTATCATGG
TCTGGGTATGGGGGGAAAATTGGT -> CTGGGTATGGGGGGAAAATTGGTC
TCGCGCATGGCGTTCATATCCGTT -> CGCGCATGGCGTTCATATCCGTTC
CCGAAACGGGGCGTTGTGATTAGG -> CGAAACGGGGCGTTGTGATTAGGA
TAACTAGCGCATTGGACGCTGATT -> AACTAGCGCATTGGACGCTGATTT
GGGGGTTCTGATATGATTTGGTCA -> GGGGTTCTGATATGATTTGGTCAT
GTCGCAACACCGCAACGAAACACA -> TCGCAACACCGCAACGAAACACAA
CTGTGTCACTGAACTCGCTGATTG -> TGTGTCACTGAACTCGCTGATTGG
ATTAGGCTACGGCTTGATGGCATG -> TTAGGCTACGGCTTGATGGCATGT
TATGCTCTTAGGCTGGCTAGATGT -> ATGCTCTTAGGCTGGCTAGATGTA
ACCTAGGTCAGGACTATGCTCTTA -> CCTAGGTCAGGACTATGCTCTTAG
CATGATGTGACTTATGCCCAACTC -> ATGATGTGACTTATGCCCAACTCC
GAACGTCCATCAACCCTCGATGTT -> AACGTCCATCAACCCTCGATGTTT
GCAACACCGCAACGAAACACAATA -> CAACACCGCAACGAAACACAATAC
TATAGATATTGACTATTGTCCCCA -> ATAGATATTGACTATTGTCCCCAA
CTAGCGCATTGGACGCTGATTTCG -> TAGCGCATTGGACGCTGATTTCGC
AACGAAACACAATACCGCCGATTG -> ACGAAACACAATACCGCCGATTGT
TCAACGAAGTGGGCCACACCAATT -> CAACGAAGTGGGCCACACCAATTC
CGTACTGACTCCTTCCTCGCGCAG -> GTACTGACTCCTTCCTCGCGCAGG
TCCTAGCATGAGGCCGCGTGGCTG -> CCTAGCATGAGGCCGCGTGGCTGC
AAAAGAAGTCCGATGAGAAAAAGT -> AAAGAAGTCCGATGAGAAAAAGTA
GAAGTCTCTGGGGGTATTTATCAT -> AAGTCTCTGGGGGTATTTATCATG
GGCGGATTTGACAGCCACCTAGGT -> GCGGATTTGACAGCCACCTAGGTC
TGAATTGGCCATGTCCGTATTTTC -> GAATTGGCCATGTCCGTATTTTCA
TACCCGGTACACCCTTCCTCTTGG -> ACCCGGTACACCCTTCCTCTTGGG
GTACTTCGCGCATGGCGTTCATAT -> TACTTCGCGCATGGCGTTCATATC
ACTGAACTCGCTGATTGGTCGACC -> CTGAACTCGCTGATTGGTCGACCG
TCCTCTTGGGTCGTCTGAACTACT -> CCTCTTGGGTCGTCTGAACTACTG
TTACATACTGCGTCCCACGCCCAA -> TACATACTGCGTCCCACGCCCAAT
CATCCGGGATGCGTGTGCCGTCCC -> ATCCGGGATGCGTGTGCCGTCCCC
CACCTGGCAGTATTGAGGCTATGA -> ACCTGGCAGTATTGAGGCTATGAA
TTAGGACGTGGTACCCTCCTCGGA -> TAGGACGTGGTACCCTCCTCGGAA
CGACTTCTCAACTATCCACTGTGT -> GACTTCTCAACTATCCACTGTGTC
CTTATGCCCAACTCCGGGGTTTAG -> TTATGCCCAACTCCGGGGTTTAGA
GCCCAATGGCACTCCTGGTCTCAC -> CCCAATGGCACTCCTGGTCTCACA
GAGGCTATGAACAACATATAGATA -> AGGCTATGAACAACATATAGATAT
GCACTCCTAGCCGATACTACGAAG -> CACTCCTAGCCGATACTACGAAGA
CAACGAAACACAATACCGCCGATT -> AACGAAACACAATACCGCCGATTG
AATGCTTCAGTTAGACCGATCGGC -> ATGCTTCAGTTAGACCGATCGGCT
ACAAATGCTATAGAACCCGGCGCG -> CAAATGCTATAGAACCCGGCGCGC
GCAGTTTGACCCCGTGTCGTACCT -> CAGTTTGACCCCGTGTCGTACCTG
TTTACATACTGCGTCCCACGCCCA -> TTACATACTGCGTCCCACGCCCAA
GTTCGGAAGTCTCTGGGGGTATTT -> TTCGGAAGTCTCTGGGGGTATTTA
CACTGTGTCACTGAACTCGCTGAT -> ACTGTGTCACTGAACTCGCTGATT
CAGATCTCACATGCCTTGTCTTGG -> AGATCTCACATGCCTTGTCTTGGC
GCCCAACTCCGGGGTTTAGATCTA -> CCCAACTCCGGGGTTTAGATCTAT
CTCATTATAAAAGGTATCCGACGT -> TCATTATAAAAGGTATCCGACGTA
CTGTGCCGTTCGGAAGTCTCTGGG -> TGTGCCGTTCGGAAGTCTCTGGGG
GGTCGGTGGTAAAAGGATCGGGAC -> GTCGGTGGTAAAAGGATCGGGACC
ACACGTACCGACCGGTGCTACATA -> CACGTACCGACCGGTGCTACATAT
TGTAGTTCCGGCCGAGGTCGGTGG -> GTAGTTCCGGCCGAGGTCGGTGGT
GTTCCTAGCATGAGGCCGCGTGGC -> TTCCTAGCATGAGGCCGCGTGGCT
CATGGCGTTCATATCCGTTCCGAC -> ATGGCGTTCATATCCGTTCCGACT
GAGAATGGCTCCGGTTTCAGCCAC -> AGAATGGCTCCGGTTTCAGCCACT
GACCCTTGGCCATAGCCGTAACTA -> ACCCTTGGCCATAGCCGTAACTAG
CCGATCGGCTGTTAGCTCAACCTG -> CGATCGGCTGTTAGCTCAACCTGC
ATCTGCGGGGGTTCTGATATGATT -> TCTGCGGGGGTTCTGATATGATTT
TTCTCAACTATCCACTGTGTCACT -> TCTCAACTATCCACTGTGTCACTG
GCCGAGGTCGGTGGTAAAAGGATC -> CCGAGGTCGGTGGTAAAAGGATCG
ATCCAATCATAATGGAGGACATTG -> TCCAATCATAATGGAGGACATTGT
ATGGAGCATTTGCGTTACACGTAC -> TGGAGCATTTGCGTTACACGTACC
TAATCATATTCCAACCTTTTTCCA -> AATCATATTCCAACCTTTTTCCAA
CTCAACCTGCGCAGGACTGAAGAC -> TCAACCTGCGCAGGACTGAAGACA
AGTCTTACGAGAAACTATTAGGCT -> GTCTTACGAGAAACTATTAGGCTA
TGTCCGATTTGTCACTTCGAGAAT -> GTCCGATTTGTCACTTCGAGAATG
TACACGTACCGACCGGTGCTACAT -> ACACGTACCGACCGGTGCTACATA
GTTAGATCGACTATAGGTCAACCC -> TTAGATCGACTATAGGTCAACCCT
GTCGACCGAGATATCGCTTGTGAT -> TCGACCGAGATATCGCTTGTGATA
TTAGCTCAACCTGCGCAGGACTGA -> TAGCTCAACCTGCGCAGGACTGAA
TACTGAGAACCGGGGCAGTGGAGG -> ACTGAGAACCGGGGCAGTGGAGGC
TGAGAAAAAGTACCGGTAAACATA -> GAGAAAAAGTACCGGTAAACATAC
ACTATTGTCCCCAAAAATGTTGGA -> CTATTGTCCCCAAAAATGTTGGAC
CGGTTTTCCATCGAGAAATCATAC -> GGTTTTCCATCGAGAAATCATACG
AGTCCGATGAGAAAAAGTACCGGT -> GTCCGATGAGAAAAAGTACCGGTA
AGCATGGCCGATCTTTCGATATAC -> GCATGGCCGATCTTTCGATATACG
ACTGTCTATGAGTAATCTTTACCT -> CTGTCTATGAGTAATCTTTACCTC
CTCGATTAATTCGGTGCCTGCCTT -> TCGATTAATTCGGTGCCTGCCTTA
TGCCCAACTCCGGGGTTTAGATCT -> GCCCAACTCCGGGGTTTAGATCTA
TTGCCCCGAGCCTAGTCACGGCAA -> TGCCCCGAGCCTAGTCACGGCAAA
ATTGGACGCTGATTTCGCTTGAGT -> TTGGACGCTGATTTCGCTTGAGTT
TCATAGGGTTCTCTGCGCTATTGC -> CATAGGGTTCTCTGCGCTATTGCG
CCGCCGATTGTTTACATACTGCGT -> CGCCGATTGTTTACATACTGCGTC
AAGGATCGGGACCGAAACGGGGCG -> AGGATCGGGACCGAAACGGGGCGT
CCAATTCGTCCACAAGCTGGGGTG -> CAATTCGTCCACAAGCTGGGGTGT
TCTATATCGTTAATTCGTGTATGA -> CTATATCGTTAATTCGTGTATGAC
GTGTCACTGAACTCGCTGATTGGT -> TGTCACTGAACTCGCTGATTGGTC
GGACCGAAACGGGGCGTTGTGATT -> GACCGAAACGGGGCGTTGTGATTA
CGGCACAGAAGAGTAGTCCCCTCC -> GGCACAGAAGAGTAGTCCCCTCCA
TCCTTCCTCGCGCAGGTAGCATGA -> CCTTCCTCGCGCAGGTAGCATGAT
ATTGTTTACATACTGCGTCCCACG -> TTGTTTACATACTGCGTCCCACGC
GTACCGGTAAACATACTTAGTCAG -> TACCGGTAAACATACTTAGTCAGG
ACTTGAAGTACATGATTCCAGAAC -> CTTGAAGTACATGATTCCAGAACC
CCCTTGGCCATAGCCGTAACTAGC -> CCTTGGCCATAGCCGTAACTAGCG
TATTTTAGTTCCGCAGTCTCGCTG -> ATTTTAGTTCCGCAGTCTCGCTGG
TTTTCACTCGATTAATTCGGTGCC -> TTTCACTCGATTAATTCGGTGCCT
CCAATGGCACTCCTGGTCTCACAG -> CAATGGCACTCCTGGTCTCACAGG
TAGCATGAGGCCGCGTGGCTGCAG -> AGCATGAGGCCGCGTGGCTGCAGT
ATACTTAGTCAGGGGCAAGTCACA -> TACTTAGTCAGGGGCAAGTCACAC
CAGCCACTGAACAGAGGACTCAGA -> AGCCACTGAACAGAGGACTCAGAT
CACTTGAAGTACATGATTCCAGAA -> ACTTGAAGTACATGATTCCAGAAC
AATTTGCACTCCTAGCCGATACTA -> ATTTGCACTCCTAGCCGATACTAC
ACACAAATGCTATAGAACCCGGCG -> CACAAATGCTATAGAACCCGGCGC
TGATTTCGCTTGAGTTGACATCCG -> GATTTCGCTTGAGTTGACATCCGG
TTGTTTACATACTGCGTCCCACGC -> TGTTTACATACTGCGTCCCACGCC
GCCCCGAGCCTAGTCACGGCAAAA -> CCCCGAGCCTAGTCACGGCAAAAG
GCGCGCGTCTGCATACGGCTAGCA -> CGCGCGTCTGCATACGGCTAGCAT
AATTGGTCAATGTTCGCGGTCCAT -> ATTGGTCAATGTTCGCGGTCCATC
ATCAACCCTCGATGTTTGTACGGG -> TCAACCCTCGATGTTTGTACGGGT
TCGTCTGAACTACTGAGAACCGGG -> CGTCTGAACTACTGAGAACCGGGG
TCTGAACTACTGAGAACCGGGGCA -> CTGAACTACTGAGAACCGGGGCAG
ACGAGAAACTATTAGGCTACGGCT -> CGAGAAACTATTAGGCTACGGCTT
GACCATCGAACTCTGAAGCTCCAA -> ACCATCGAACTCTGAAGCTCCAAA
GCATGATGTGACTTATGCCCAACT -> CATGATGTGACTTATGCCCAACTC
TCGACTATAGGTCAACCCTAGGTG -> CGACTATAGGTCAACCCTAGGTGC
ACATACTGCGTCCCACGCCCAATG -> CATACTGCGTCCCACGCCCAATGG
GGCCATGTCCGTATTTTCACTCGA -> GCCATGTCCGTATTTTCACTCGAT
GCATGGCGTTCATATCCGTTCCGA -> CATGGCGTTCATATCCGTTCCGAC
GTCACTTCGAGAATGGCTCCGGTT -> TCACTTCGAGAATGGCTCCGGTTT
CTATCCACTGTGTCACTGAACTCG -> TATCCACTGTGTCACTGAACTCGC
GTGTGCCGTCCCCGTATCTTTCGT -> TGTGCCGTCCCCGTATCTTTCGTA
GGCTGCAGTTTGACCCCGTGTCGT -> GCTGCAGTTTGACCCCGTGTCGTA
ACTATCCACTGTGTCACTGAACTC -> CTATCCACTGTGTCACTGAACTCG
GCGTGGCTGCAGTTTGACCCCGTG -> CGTGGCTGCAGTTTGACCCCGTGT
CCTCGGAACGTCACGAGAATGATC -> CTCGGAACGTCACGAGAATGATCA
CACAATACCGCCGATTGTTTACAT -> ACAATACCGCCGATTGTTTACATA
TATCCAGTATGTCCGATTTGTCAC -> ATCCAGTATGTCCGATTTGTCACT
TACCTCTACATTCGTCTTGCCCCG -> ACCTCTACATTCGTCTTGCCCCGA
ATGATGTGACTTATGCCCAACTCC -> TGATGTGACTTATGCCCAACTCCG
ATTTGCACTCCTAGCCGATACTAC -> TTTGCACTCCTAGCCGATACTACG
ACTCCGGGGTTTAGATCTATATCG -> CTCCGGGGTTTAGATCTATATCGT
CTGAAGCTCCAAACGTACTTTACC -> TGAAGCTCCAAACGTACTTTACCC
TAAGGTGATCTGCGGGGGTTCTGA -> AAGGTGATCTGCGGGGGTTCTGAT
TACGGCAGTCGCAACACCGCAACG -> ACGGCAGTCGCAACACCGCAACGA
GGTGTAATCATATTCCAACCTTTT -> GTGTAATCATATTCCAACCTTTTT
CTGGGTATGGGGGGAAAATTGGTC -> TGGGTATGGGGGGAAAATTGGTCA
AGCCACCTAGGTCAGGACTATGCT -> GCCACCTAGGTCAGGACTATGCTC
TTCCATCGAGAAATCATACGGTTC -> TCCATCGAGAAATCATACGGTTCT
TGCATCGCCCAAGGGACGTATGAA -> GCATCGCCCAAGGGACGTATGAAT
ATATCGTTAATTCGTGTATGACAG -> TATCGTTAATTCGTGTATGACAGG
TCGCTCGTAAGGTGATCTGCGGGG -> CGCTCGTAAGGTGATCTGCGGGGG
CTGCAGTTTGACCCCGTGTCGTAC -> TGCAGTTTGACCCCGTGTCGTACC
AAGCTCCAAACGTACTTTACCCCG -> AGCTCCAAACGTACTTTACCCCGC
CCCTCGCATGTATCGACGCGTAAA -> CCTCGCATGTATCGACGCGTAAAT
TACTGTCTATGAGTAATCTTTACC -> ACTGTCTATGAGTAATCTTTACCT
ACACCTGGCAGTATTGAGGCTATG -> CACCTGGCAGTATTGAGGCTATGA
AACATCAACGAAGTGGGCCACACC -> ACATCAACGAAGTGGGCCACACCA
TTTACCCCGCAGGTCGGCGGATTT -> TTACCCCGCAGGTCGGCGGATTTG
CCGATTGTTTACATACTGCGTCCC -> CGATTGTTTACATACTGCGTCCCA
CGATCGGCTGTTAGCTCAACCTGC -> GATCGGCTGTTAGCTCAACCTGCG
TCACAGGTGCTACTGCCGTCCAGA -> CACAGGTGCTACTGCCGTCCAGAC
TGCATACGGCTAGCATGGCCGATC -> GCATACGGCTAGCATGGCCGATCT
CCGGGGCAGTGGAGGCCTATAACA -> CGGGGCAGTGGAGGCCTATAACAA
TCTTAGGCTGGCTAGATGTACTTC -> CTTAGGCTGGCTAGATGTACTTCG
ATTTGCGTTACACGTACCGACCGG -> TTTGCGTTACACGTACCGACCGGT
TATGAGTAATCTTTACCTCTACAT -> ATGAGTAATCTTTACCTCTACATT
GCTACTGCCGTCCAGACCATGGAG -> CTACTGCCGTCCAGACCATGGAGC
ATTTGACAGCCACCTAGGTCAGGA -> TTTGACAGCCACCTAGGTCAGGAC
TCACACAAATGCTATAGAACCCGG -> CACACAAATGCTATAGAACCCGGC
ACCTCTACATTCGTCTTGCCCCGA -> CCTCTACATTCGTCTTGCCCCGAG
ACTTCGCGCATGGCGTTCATATCC -> CTTCGCGCATGGCGTTCATATCCG
CATGTATCGACGCGTAAATACCCG -> ATGTATCGACGCGTAAATACCCGG
ATGAGGCCGCGTGGCTGCAGTTTG -> TGAGGCCGCGTGGCTGCAGTTTGA
AACCTTTTTCCAATCCTCAACATC -> ACCTTTTTCCAATCCTCAACATCA
CTTTACCTCTACATTCGTCTTGCC -> TTTACCTCTACATTCGTCTTGCCC
GGTCAACCCTAGGTGCTGTAGTTC -> GTCAACCCTAGGTGCTGTAGTTCC
GATATCGCTTGTGATACTGTCTAT -> ATATCGCTTGTGATACTGTCTATG
ATTTGTCACTTCGAGAATGGCTCC -> TTTGTCACTTCGAGAATGGCTCCG
ACTCCTTCCTCGCGCAGGTAGCAT -> CTCCTTCCTCGCGCAGGTAGCATG
TCACGAGAATGATCATCCAATCAT -> CACGAGAATGATCATCCAATCATA
CATGGGGTTAGATCGACTATAGGT -> ATGGGGTTAGATCGACTATAGGTC
AGTGGAGGCCTATAACAACCAATT -> GTGGAGGCCTATAACAACCAATTT
AAATGTTGGACACTGCCCGGATGT -> AATGTTGGACACTGCCCGGATGTG
TAGGTCAGGACTATGCTCTTAGGC -> AGGTCAGGACTATGCTCTTAGGCT
ATGTGAATAAGGCCTGTTGAATGC -> TGTGAATAAGGCCTGTTGAATGCT
ACTTCTCAACTATCCACTGTGTCA -> CTTCTCAACTATCCACTGTGTCAC
CAAGGGACGTATGAATTGGCCATG -> AAGGGACGTATGAATTGGCCATGT
GTGCTACATCATTTCGGATCACAG -> TGCTACATCATTTCGGATCACAGG
AGACAAGTCTGGGTATGGGGGGAA -> GACAAGTCTGGGTATGGGGGGAAA
AGATGTACTTCGCGCATGGCGTTC -> GATGTACTTCGCGCATGGCGTTCA
GTGACTCCTCATTATAAAAGGTAT -> TGACTCCTCATTATAAAAGGTATC
TCCGATGAGAAAAAGTACCGGTAA -> CCGATGAGAAAAAGTACCGGTAAA
TCAACTATCCACTGTGTCACTGAA -> CAACTATCCACTGTGTCACTGAAC
GAAACACAATACCGCCGATTGTTT -> AAACACAATACCGCCGATTGTTTA
CCGAGCCTAGTCACGGCAAAAGTT -> CGAGCCTAGTCACGGCAAAAGTTG
GATTTGACAGCCACCTAGGTCAGG -> ATTTGACAGCCACCTAGGTCAGGA
GCCTTGTCTTGGCGAGCACTTGAA -> CCTTGTCTTGGCGAGCACTTGAAG
GCCCAAGGGACGTATGAATTGGCC -> CCCAAGGGACGTATGAATTGGCCA
GCTGGACCCTTGGCCATAGCCGTA -> CTGGACCCTTGGCCATAGCCGTAA
CGAAGTGGGCCACACCAATTCGTC -> GAAGTGGGCCACACCAATTCGTCC
CTAGCATGGCCGATCTTTCGATAT -> TAGCATGGCCGATCTTTCGATATA
TAGACCGATCGGCTGTTAGCTCAA -> AGACCGATCGGCTGTTAGCTCAAC
AAATTGGTCAATGTTCGCGGTCCA -> AATTGGTCAATGTTCGCGGTCCAT
CTATTAGGCTACGGCTTGATGGCA -> TATTAGGCTACGGCTTGATGGCAT
AAAATTGGTCAATGTTCGCGGTCC -> AAATTGGTCAATGTTCGCGGTCCA
TGCGTTACACGTACCGACCGGTGC -> GCGTTACACGTACCGACCGGTGCT
CTCGATGTTTGTACGGGTTATTAC -> TCGATGTTTGTACGGGTTATTACC
ACCCGGTACACCCTTCCTCTTGGG -> CCCGGTACACCCTTCCTCTTGGGT
TATCCCAAAAGAAGTCCGATGAGA -> ATCCCAAAAGAAGTCCGATGAGAA
CGGGGCAGTGGAGGCCTATAACAA -> GGGGCAGTGGAGGCCTATAACAAC
AATGTGAATAAGGCCTGTTGAATG -> ATGTGAATAAGGCCTGTTGAATGC
TTGTGATTAGGACGTGGTACCCTC -> TGTGATTAGGACGTGGTACCCTCC
TACCGCCGATTGTTTACATACTGC -> ACCGCCGATTGTTTACATACTGCG
ACCCTTGGCCATAGCCGTAACTAG -> CCCTTGGCCATAGCCGTAACTAGC
GCGTTACACGTACCGACCGGTGCT -> CGTTACACGTACCGACCGGTGCTA
TGAACAACATATAGATATTGACTA -> GAACAACATATAGATATTGACTAT
AGGACGTGGTACCCTCCTCGGAAC -> GGACGTGGTACCCTCCTCGGAACG
CCTCCTCGGAACGTCACGAGAATG -> CTCCTCGGAACGTCACGAGAATGA
TTGAAACACAGACTGCAAGAAAGT -> TGAAACACAGACTGCAAGAAAGTC
GACGCGTAAATACCCGGTACACCC -> ACGCGTAAATACCCGGTACACCCT
GCTTGAGTTGACATCCGGGATGCG -> CTTGAGTTGACATCCGGGATGCGT
CCGTTCGGAAGTCTCTGGGGGTAT -> CGTTCGGAAGTCTCTGGGGGTATT
CCTCATTATAAAAGGTATCCGACG -> CTCATTATAAAAGGTATCCGACGT
GGCAGTTCCTAGCATGAGGCCGCG -> GCAGTTCCTAGCATGAGGCCGCGT
CTGCAAGAAAGTCTTACGAGAAAC -> TGCAAGAAAGTCTTACGAGAAACT
TGCGCAATGCTGTGCCGTTCGGAA -> GCGCAATGCTGTGCCGTTCGGAAG
ATCATAATGGAGGACATTGTGCTA -> TCATAATGGAGGACATTGTGCTAC
ATCAGGTGACTCCTCATTATAAAA -> TCAGGTGACTCCTCATTATAAAAG
CTTGAAGTACATGATTCCAGAACC -> TTGAAGTACATGATTCCAGAACCA
TATTGAGGCTATGAACAACATATA -> ATTGAGGCTATGAACAACATATAG
CCTCGCATGTATCGACGCGTAAAT -> CTCGCATGTATCGACGCGTAAATA
GCGCAGGACTGAAGACAAGTCTGG -> CGCAGGACTGAAGACAAGTCTGGG
GGAAAATTGGTCAATGTTCGCGGT -> GAAAATTGGTCAATGTTCGCGGTC
GGGGTTAGATCGACTATAGGTCAA -> GGGTTAGATCGACTATAGGTCAAC
TGGCCATAGCCGTAACTAGCGCAT -> GGCCATAGCCGTAACTAGCGCATT
CTGATATGATTTGGTCATGGTTCT -> TGATATGATTTGGTCATGGTTCTA
TGCCTGCCTTAGCGCAGATCTCAC -> GCCTGCCTTAGCGCAGATCTCACA
GTTAATTCGTGTATGACAGGCAGT -> TTAATTCGTGTATGACAGGCAGTT
TCATAATGGAGGACATTGTGCTAC -> CATAATGGAGGACATTGTGCTACA
CATGGCCGATCTTTCGATATACGG -> ATGGCCGATCTTTCGATATACGGC
CCTTAGCGCAGATCTCACATGCCT -> CTTAGCGCAGATCTCACATGCCTT
GATCTCGGATTACGGCACAGAAGA -> ATCTCGGATTACGGCACAGAAGAG
AAAATGTTGGACACTGCCCGGATG -> AAATGTTGGACACTGCCCGGATGT
AACAACCAATTTAGCCCGCTATCA -> ACAACCAATTTAGCCCGCTATCAG
TCCACTGTGTCACTGAACTCGCTG -> CCACTGTGTCACTGAACTCGCTGA
TAATATCCGGTGTAATCATATTCC -> AATATCCGGTGTAATCATATTCCA
TAGTTCCGGCCGAGGTCGGTGGTA -> AGTTCCGGCCGAGGTCGGTGGTAA
AGATCTCGGATTACGGCACAGAAG -> GATCTCGGATTACGGCACAGAAGA
TGACTCCTCATTATAAAAGGTATC -> GACTCCTCATTATAAAAGGTATCC
ATGAATTGGCCATGTCCGTATTTT -> TGAATTGGCCATGTCCGTATTTTC
CAATGCTGTGCCGTTCGGAAGTCT -> AATGCTGTGCCGTTCGGAAGTCTC
AGTCGCAACACCGCAACGAAACAC -> GTCGCAACACCGCAACGAAACACA
TGGGGGGAAAATTGGTCAATGTTC -> GGGGGGAAAATTGGTCAATGTTCG
ACATATCAGTGTTTATCTCGTCGT -> CATATCAGTGTTTATCTCGTCGTC
CCTCAACATCAACGAAGTGGGCCA -> CTCAACATCAACGAAGTGGGCCAC
AACTATTAGGCTACGGCTTGATGG -> ACTATTAGGCTACGGCTTGATGGC
CTCGGAACGTCACGAGAATGATCA -> TCGGAACGTCACGAGAATGATCAT
TCATCCAATCATAATGGAGGACAT -> CATCCAATCATAATGGAGGACATT
TTTCCATCGAGAAATCATACGGTT -> TTCCATCGAGAAATCATACGGTTC
CCCGGTTTTCCATCGAGAAATCAT -> CCGGTTTTCCATCGAGAAATCATA
CTAGTCACGGCAAAAGTTGAAACA -> TAGTCACGGCAAAAGTTGAAACAC
CAGGTGACTCCTCATTATAAAAGG -> AGGTGACTCCTCATTATAAAAGGT
TGATTAGGACGTGGTACCCTCCTC -> GATTAGGACGTGGTACCCTCCTCG
CATATCGACACCTGGCAGTATTGA -> ATATCGACACCTGGCAGTATTGAG
GCAGTATTGAGGCTATGAACAACA -> CAGTATTGAGGCTATGAACAACAT
CGCAACGAAACACAATACCGCCGA -> GCAACGAAACACAATACCGCCGAT
ATCAGTGTTTATCTCGTCGTCGGT -> TCAGTGTTTATCTCGTCGTCGGTC
CGAACTCTGAAGCTCCAAACGTAC -> GAACTCTGAAGCTCCAAACGTACT
TCCGGGGTTTAGATCTATATCGTT -> CCGGGGTTTAGATCTATATCGTTA
CTGGCTAGATGTACTTCGCGCATG -> TGGCTAGATGTACTTCGCGCATGG
ACATATAGATATTGACTATTGTCC -> CATATAGATATTGACTATTGTCCC
GTTTAGATCTATATCGTTAATTCG -> TTTAGATCTATATCGTTAATTCGT
CCATGTCCGTATTTTCACTCGATT -> CATGTCCGTATTTTCACTCGATTA
ACCAATTTGCACTCCTAGCCGATA -> CCAATTTGCACTCCTAGCCGATAC
AAACACAATACCGCCGATTGTTTA -> AACACAATACCGCCGATTGTTTAC
CCATCGCTCCGAACGTCCATCAAC -> CATCGCTCCGAACGTCCATCAACC
TCGGTCGCGTACTGACTCCTTCCT -> CGGTCGCGTACTGACTCCTTCCTC
TATAGGTCAACCCTAGGTGCTGTA -> ATAGGTCAACCCTAGGTGCTGTAG
CGCAGGTCGGCGGATTTGACAGCC -> GCAGGTCGGCGGATTTGACAGCCA
TGTGAATAAGGCCTGTTGAATGCT -> GTGAATAAGGCCTGTTGAATGCTT
TCAACCCTAGGTGCTGTAGTTCCG -> CAACCCTAGGTGCTGTAGTTCCGG
AATGTTGGACACTGCCCGGATGTG -> ATGTTGGACACTGCCCGGATGTGA
TCCTCATTATAAAAGGTATCCGAC -> CCTCATTATAAAAGGTATCCGACG
GGCCGCGTGGCTGCAGTTTGACCC -> GCCGCGTGGCTGCAGTTTGACCCC
CGAGAAACTATTAGGCTACGGCTT -> GAGAAACTATTAGGCTACGGCTTG
CAACATCAACGAAGTGGGCCACAC -> AACATCAACGAAGTGGGCCACACC
CAGGCGCTACTTTTAGTCATAGGG -> AGGCGCTACTTTTAGTCATAGGGT
ACAGAGGACTCAGATCTCGGATTA -> CAGAGGACTCAGATCTCGGATTAC
AAGAGTAGTCCCCTCCAAAGACCA -> AGAGTAGTCCCCTCCAAAGACCAT
TATCGCTTGTGATACTGTCTATGA -> ATCGCTTGTGATACTGTCTATGAG
AAAGTCTTACGAGAAACTATTAGG -> AAGTCTTACGAGAAACTATTAGGC
TCGCTGGACCCTTGGCCATAGCCG -> CGCTGGACCCTTGGCCATAGCCGT
ATGACAGGCAGTTCCTAGCATGAG -> TGACAGGCAGTTCCTAGCATGAGG
TCCGAACGTCCATCAACCCTCGAT -> CCGAACGTCCATCAACCCTCGATG
TCTTGCCCCGAGCCTAGTCACGGC -> CTTGCCCCGAGCCTAGTCACGGCA
TCCAATCCTCAACATCAACGAAGT -> CCAATCCTCAACATCAACGAAGTG
GAGAAATCATACGGTTCTATCCAG -> AGAAATCATACGGTTCTATCCAGT
GCTCGTAAGGTGATCTGCGGGGGT -> CTCGTAAGGTGATCTGCGGGGGTT
GCATTTGCGTTACACGTACCGACC -> CATTTGCGTTACACGTACCGACCG
TCGCAACACCGCAACGAAACACAA -> CGCAACACCGCAACGAAACACAAT
AGAGCATACCCCTCGCATGTATCG -> GAGCATACCCCTCGCATGTATCGA
ATCGCCCAAGGGACGTATGAATTG -> TCGCCCAAGGGACGTATGAATTGG
CTGGGGGTATTTATCATGGGGTTA -> TGGGGGTATTTATCATGGGGTTAG
AGCTGGGGTGTGCATCGCCCAAGG -> GCTGGGGTGTGCATCGCCCAAGGG
ACAATACCGCCGATTGTTTACATA -> CAATACCGCCGATTGTTTACATAC
CACACCAATTCGTCCACAAGCTGG -> ACACCAATTCGTCCACAAGCTGGG
GCCGTTCGGAAGTCTCTGGGGGTA -> CCGTTCGGAAGTCTCTGGGGGTAT
ATACGGCTAGCATGGCCGATCTTT -> TACGGCTAGCATGGCCGATCTTTC
TAGTCCCCTCCAAAGACCATCGAA -> AGTCCCCTCCAAAGACCATCGAAC
ATCCTCAACATCAACGAAGTGGGC -> TCCTCAACATCAACGAAGTGGGCC
CCAGTATGTCCGATTTGTCACTTC -> CAGTATGTCCGATTTGTCACTTCG
GTATTTTCACTCGATTAATTCGGT -> TATTTTCACTCGATTAATTCGGTG
TGAACTCGCTGATTGGTCGACCGA -> GAACTCGCTGATTGGTCGACCGAG
CGGTTCTATCCAGTATGTCCGATT -> GGTTCTATCCAGTATGTCCGATTT
CGGCTTGATGGCATGTCACTGTAG -> GGCTTGATGGCATGTCACTGTAGT
GTTCGCGGTCCATCGCTCCGAACG -> TTCGCGGTCCATCGCTCCGAACGT
GTTGAAACACAGACTGCAAGAAAG -> TTGAAACACAGACTGCAAGAAAGT
GATGTGACTTATGCCCAACTCCGG -> ATGTGACTTATGCCCAACTCCGGG
GCCGATTGTTTACATACTGCGTCC -> CCGATTGTTTACATACTGCGTCCC
AGTACATGATTCCAGAACCAATTT -> GTACATGATTCCAGAACCAATTTG
CATGGTTCTATTTTAGTTCCGCAG -> ATGGTTCTATTTTAGTTCCGCAGT
CCATGGAGCATTTGCGTTACACGT -> CATGGAGCATTTGCGTTACACGTA
CTACATCATTTCGGATCACAGGTG -> TACATCATTTCGGATCACAGGTGC
CAGGACTATGCTCTTAGGCTGGCT -> AGGACTATGCTCTTAGGCTGGCTA
ACGTACCGACCGGTGCTACATATC -> CGTACCGACCGGTGCTACATATCG
ATGTGACTTATGCCCAACTCCGGG -> TGTGACTTATGCCCAACTCCGGGG
ATCATATTCCAACCTTTTTCCAAT -> TCATATTCCAACCTTTTTCCAATC
ATGTCCGTATTTTCACTCGATTAA -> TGTCCGTATTTTCACTCGATTAAT
CAGGACTGAAGACAAGTCTGGGTA -> AGGACTGAAGACAAGTCTGGGTAT
GCATGTATCGACGCGTAAATACCC -> CATGTATCGACGCGTAAATACCCG
CGAAGAGAGTTCCATTGTCGCTCG -> GAAGAGAGTTCCATTGTCGCTCGT
TCACTTCGAGAATGGCTCCGGTTT -> CACTTCGAGAATGGCTCCGGTTTC
TGGTTCTATTTTAGTTCCGCAGTC -> GGTTCTATTTTAGTTCCGCAGTCT
GGAAGTCTCTGGGGGTATTTATCA -> GAAGTCTCTGGGGGTATTTATCAT
GTATGGGGGGAAAATTGGTCAATG -> TATGGGGGGAAAATTGGTCAATGT
ACGGCTTGATGGCATGTCACTGTA -> CGGCTTGATGGCATGTCACTGTAG
TGCTACATCATTTCGGATCACAGG -> GCTACATCATTTCGGATCACAGGT
CGCTGATTGGTCGACCGAGATATC -> GCTGATTGGTCGACCGAGATATCG
GGTGACATATCAGTGTTTATCTCG -> GTGACATATCAGTGTTTATCTCGT
GAAGACAAGTCTGGGTATGGGGGG -> AAGACAAGTCTGGGTATGGGGGGA
GAAACTATTAGGCTACGGCTTGAT -> AAACTATTAGGCTACGGCTTGATG
CTTAGCGCAGATCTCACATGCCTT -> TTAGCGCAGATCTCACATGCCTTG
CAGAACCAATTTGCACTCCTAGCC -> AGAACCAATTTGCACTCCTAGCCG
CACATGCCTTGTCTTGGCGAGCAC -> ACATGCCTTGTCTTGGCGAGCACT
CGCGTGGCTGCAGTTTGACCCCGT -> GCGTGGCTGCAGTTTGACCCCGTG
TAGGGTTCTCTGCGCTATTGCGCA -> AGGGTTCTCTGCGCTATTGCGCAA
ATCCACTGTGTCACTGAACTCGCT -> TCCACTGTGTCACTGAACTCGCTG
GAAAACTAATATCCGGTGTAATCA -> AAAACTAATATCCGGTGTAATCAT
ATCATGGGGTTAGATCGACTATAG -> TCATGGGGTTAGATCGACTATAGG
ACGCGTAAATACCCGGTACACCCT -> CGCGTAAATACCCGGTACACCCTT
AGTGGGCCACACCAATTCGTCCAC -> GTGGGCCACACCAATTCGTCCACA
CGGCAGTCGCAACACCGCAACGAA -> GGCAGTCGCAACACCGCAACGAAA
TAGGACGTGGTACCCTCCTCGGAA -> AGGACGTGGTACCCTCCTCGGAAC
CATTGTCGCTCGTAAGGTGATCTG -> ATTGTCGCTCGTAAGGTGATCTGC
AGACCATGGAGCATTTGCGTTACA -> GACCATGGAGCATTTGCGTTACAC
TTAATTCGTGTATGACAGGCAGTT -> TAATTCGTGTATGACAGGCAGTTC
CGGTGTAATCATATTCCAACCTTT -> GGTGTAATCATATTCCAACCTTTT
ATCAACGAAGTGGGCCACACCAAT -> TCAACGAAGTGGGCCACACCAATT
GAGGACTCAGATCTCGGATTACGG -> AGGACTCAGATCTCGGATTACGGC
TTACGAGAAACTATTAGGCTACGG -> TACGAGAAACTATTAGGCTACGGC
GGATCGGGACCGAAACGGGGCGTT -> GATCGGGACCGAAACGGGGCGTTG
GCGCAGATCTCACATGCCTTGTCT -> CGCAGATCTCACATGCCTTGTCTT
GTATTGAGGCTATGAACAACATAT -> TATTGAGGCTATGAACAACATATA
CGTACTTTACCCCGCAGGTCGGCG -> GTACTTTACCCCGCAGGTCGGCGG
TGGGGGTATTTATCATGGGGTTAG -> GGGGGTATTTATCATGGGGTTAGA
ACGGCACAGAAGAGTAGTCCCCTC -> CGGCACAGAAGAGTAGTCCCCTCC
GTGATACTGTCTATGAGTAATCTT -> TGATACTGTCTATGAGTAATCTTT
AGGTAGCATGATGTGACTTATGCC -> GGTAGCATGATGTGACTTATGCCC
AGGTCGGCGGATTTGACAGCCACC -> GGTCGGCGGATTTGACAGCCACCT
AGGCTATGAACAACATATAGATAT -> GGCTATGAACAACATATAGATATT
CCACGCCCAATGGCACTCCTGGTC -> CACGCCCAATGGCACTCCTGGTCT
TCTACATTCGTCTTGCCCCGAGCC -> CTACATTCGTCTTGCCCCGAGCCT
AAACTATTAGGCTACGGCTTGATG -> AACTATTAGGCTACGGCTTGATGG
AGCCACTGAACAGAGGACTCAGAT -> GCCACTGAACAGAGGACTCAGATC
CATACGGCTAGCATGGCCGATCTT -> ATACGGCTAGCATGGCCGATCTTT
ACCCTCCTCGGAACGTCACGAGAA -> CCCTCCTCGGAACGTCACGAGAAT
ATACCCCTCGCATGTATCGACGCG -> TACCCCTCGCATGTATCGACGCGT
GCTGTAGTTCCGGCCGAGGTCGGT -> CTGTAGTTCCGGCCGAGGTCGGTG
TCGTAAGAGCATACCCCTCGCATG -> CGTAAGAGCATACCCCTCGCATGT
GCGTCCCACGCCCAATGGCACTCC -> CGTCCCACGCCCAATGGCACTCCT
GAACGTCACGAGAATGATCATCCA -> AACGTCACGAGAATGATCATCCAA
TTGACTATTGTCCCCAAAAATGTT -> TGACTATTGTCCCCAAAAATGTTG
TCCATTGTCGCTCGTAAGGTGATC -> CCATTGTCGCTCGTAAGGTGATCT
CGAGAATGGCTCCGGTTTCAGCCA -> GAGAATGGCTCCGGTTTCAGCCAC
GGGGTGTGCATCGCCCAAGGGACG -> GGGTGTGCATCGCCCAAGGGACGT
CCCTCGATGTTTGTACGGGTTATT -> CCTCGATGTTTGTACGGGTTATTA
CTCGCTGATTGGTCGACCGAGATA -> TCGCTGATTGGTCGACCGAGATAT
AATGCTATAGAACCCGGCGCGCGT -> ATGCTATAGAACCCGGCGCGCGTC
TCCGGTTTCAGCCACTGAACAGAG -> CCGGTTTCAGCCACTGAACAGAGG
CCGAGGTCGGTGGTAAAAGGATCG -> CGAGGTCGGTGGTAAAAGGATCGG
CAGGTGCTACTGCCGTCCAGACCA -> AGGTGCTACTGCCGTCCAGACCAT
AAGCTGGGGTGTGCATCGCCCAAG -> AGCTGGGGTGTGCATCGCCCAAGG
GTTTATCTCGTCGTCGGTCGCGTA -> TTTATCTCGTCGTCGGTCGCGTAC
AGATCTATATCGTTAATTCGTGTA -> GATCTATATCGTTAATTCGTGTAT
ACTATTAGGCTACGGCTTGATGGC -> CTATTAGGCTACGGCTTGATGGCA
AATGATCATCCAATCATAATGGAG -> ATGATCATCCAATCATAATGGAGG
GAGCATACCCCTCGCATGTATCGA -> AGCATACCCCTCGCATGTATCGAC
TGTACTTCGCGCATGGCGTTCATA -> GTACTTCGCGCATGGCGTTCATAT
TAAGGCCTGTTGAATGCTTCAGTT -> AAGGCCTGTTGAATGCTTCAGTTA
ATTTTAGTTCCGCAGTCTCGCTGG -> TTTTAGTTCCGCAGTCTCGCTGGA
CGTCCATCAACCCTCGATGTTTGT -> GTCCATCAACCCTCGATGTTTGTA
ATTCCAACCTTTTTCCAATCCTCA -> TTCCAACCTTTTTCCAATCCTCAA
TCCGGGATGCGTGTGCCGTCCCCG -> CCGGGATGCGTGTGCCGTCCCCGT
TTCTGATATGATTTGGTCATGGTT -> TCTGATATGATTTGGTCATGGTTC
GGGGGAAAATTGGTCAATGTTCGC -> GGGGAAAATTGGTCAATGTTCGCG
AGCCCGCTATCAGGTGACTCCTCA -> GCCCGCTATCAGGTGACTCCTCAT
CCCAAAAGAAGTCCGATGAGAAAA -> CCAAAAGAAGTCCGATGAGAAAAA
AACCAATTTGCACTCCTAGCCGAT -> ACCAATTTGCACTCCTAGCCGATA
TCGATTAATTCGGTGCCTGCCTTA -> CGATTAATTCGGTGCCTGCCTTAG
TTCGTCCACAAGCTGGGGTGTGCA -> TCGTCCACAAGCTGGGGTGTGCAT
AATGGAGGACATTGTGCTACATCA -> ATGGAGGACATTGTGCTACATCAT
CACACAAATGCTATAGAACCCGGC -> ACACAAATGCTATAGAACCCGGCG
GGTACACCCTTCCTCTTGGGTCGT -> GTACACCCTTCCTCTTGGGTCGTC
AGTTAGACCGATCGGCTGTTAGCT -> GTTAGACCGATCGGCTGTTAGCTC
TTCGGATCACAGGTGCTACTGCCG -> TCGGATCACAGGTGCTACTGCCGT
TCAGTTAGACCGATCGGCTGTTAG -> CAGTTAGACCGATCGGCTGTTAGC
TCAGTGTTTATCTCGTCGTCGGTC -> CAGTGTTTATCTCGTCGTCGGTCG
TTAGATCGACTATAGGTCAACCCT -> TAGATCGACTATAGGTCAACCCTA
TCGAGAAATCATACGGTTCTATCC -> CGAGAAATCATACGGTTCTATCCA
TTTAGTTCCGCAGTCTCGCTGGAC -> TTAGTTCCGCAGTCTCGCTGGACC
GTGCCTGCCTTAGCGCAGATCTCA -> TGCCTGCCTTAGCGCAGATCTCAC
TTGGCCATAGCCGTAACTAGCGCA -> TGGCCATAGCCGTAACTAGCGCAT
CTCACATGCCTTGTCTTGGCGAGC -> TCACATGCCTTGTCTTGGCGAGCA
TTCGAGAATGGCTCCGGTTTCAGC -> TCGAGAATGGCTCCGGTTTCAGCC
TGGTCATGGTTCTATTTTAGTTCC -> GGTCATGGTTCTATTTTAGTTCCG
CAACACCGCAACGAAACACAATAC -> AACACCGCAACGAAACACAATACC
ACCGCAACGAAACACAATACCGCC -> CCGCAACGAAACACAATACCGCCG
GATCATCCAATCATAATGGAGGAC -> ATCATCCAATCATAATGGAGGACA
CAAGAAAGTCTTACGAGAAACTAT -> AAGAAAGTCTTACGAGAAACTATT
CCGCGTGGCTGCAGTTTGACCCCG -> CGCGTGGCTGCAGTTTGACCCCGT
AGCACTTGAAGTACATGATTCCAG -> GCACTTGAAGTACATGATTCCAGA
CCAAAAATGTTGGACACTGCCCGG -> CAAAAATGTTGGACACTGCCCGGA
TGTTTACATACTGCGTCCCACGCC -> GTTTACATACTGCGTCCCACGCCC
CTCGTCGTCGGTCGCGTACTGACT -> TCGTCGTCGGTCGCGTACTGACTC
CAAGTCTGGGTATGGGGGGAAAAT -> AAGTCTGGGTATGGGGGGAAAATT
AAACATACTTAGTCAGGGGCAAGT -> AACATACTTAGTCAGGGGCAAGTC
TTGATGGCATGTCACTGTAGTTGG -> TGATGGCATGTCACTGTAGTTGGG
TATCCGTTCCGACTTCTCAACTAT -> ATCCGTTCCGACTTCTCAACTATC
CGTGTATGACAGGCAGTTCCTAGC -> GTGTATGACAGGCAGTTCCTAGCA
TTTCCAATCCTCAACATCAACGAA -> TTCCAATCCTCAACATCAACGAAG
GTCCGATTTGTCACTTCGAGAATG -> TCCGATTTGTCACTTCGAGAATGG
CTACTTTTAGTCATAGGGTTCTCT -> TACTTTTAGTCATAGGGTTCTCTG
GGGCAAGTCACACAAATGCTATAG -> GGCAAGTCACACAAATGCTATAGA
GTCAACCCTAGGTGCTGTAGTTCC -> TCAACCCTAGGTGCTGTAGTTCCG
ATTGGCCATGTCCGTATTTTCACT -> TTGGCCATGTCCGTATTTTCACTC
GCTAGATGTACTTCGCGCATGGCG -> CTAGATGTACTTCGCGCATGGCGT
GGATTTGACAGCCACCTAGGTCAG -> GATTTGACAGCCACCTAGGTCAGG
GCAGTCGCAACACCGCAACGAAAC -> CAGTCGCAACACCGCAACGAAACA
GCCGATACTACGAAGAGAGTTCCA -> CCGATACTACGAAGAGAGTTCCAT
CTACGAAGAGAGTTCCATTGTCGC -> TACGAAGAGAGTTCCATTGTCGCT
GTTGAATGCTTCAGTTAGACCGAT -> TTGAATGCTTCAGTTAGACCGATC
CGCAGTCTCGCTGGACCCTTGGCC -> GCAGTCTCGCTGGACCCTTGGCCA
GGACTGAAGACAAGTCTGGGTATG -> GACTGAAGACAAGTCTGGGTATGG
CTCCTTCCTCGCGCAGGTAGCATG -> TCCTTCCTCGCGCAGGTAGCATGA
GAATTGGCCATGTCCGTATTTTCA -> AATTGGCCATGTCCGTATTTTCAC
TCCAAACGTACTTTACCCCGCAGG -> CCAAACGTACTTTACCCCGCAGGT
AGGACATTGTGCTACATCATTTCG -> GGACATTGTGCTACATCATTTCGG
ACTCAGATCTCGGATTACGGCACA -> CTCAGATCTCGGATTACGGCACAG
CATCAACGAAGTGGGCCACACCAA -> ATCAACGAAGTGGGCCACACCAAT
CATCCAATCATAATGGAGGACATT -> ATCCAATCATAATGGAGGACATTG
CTCTGCGCTATTGCGCAATGCTGT -> TCTGCGCTATTGCGCAATGCTGTG
ATAGGTCAACCCTAGGTGCTGTAG -> TAGGTCAACCCTAGGTGCTGTAGT
GTCCCCTCCAAAGACCATCGAACT -> TCCCCTCCAAAGACCATCGAACTC
TCTATCCAGTATGTCCGATTTGTC -> CTATCCAGTATGTCCGATTTGTCA
ACAAGCTGGGGTGTGCATCGCCCA -> CAAGCTGGGGTGTGCATCGCCCAA
TCATGGTTCTATTTTAGTTCCGCA -> CATGGTTCTATTTTAGTTCCGCAG
CACGAGAATGATCATCCAATCATA -> ACGAGAATGATCATCCAATCATAA
GTAAGGTGATCTGCGGGGGTTCTG -> TAAGGTGATCTGCGGGGGTTCTGA
CTAGCCGATACTACGAAGAGAGTT -> TAGCCGATACTACGAAGAGAGTTC
ATGATCATCCAATCATAATGGAGG -> TGATCATCCAATCATAATGGAGGA
CGTTCCGACTTCTCAACTATCCAC -> GTTCCGACTTCTCAACTATCCACT
TGCTGTAGTTCCGGCCGAGGTCGG -> GCTGTAGTTCCGGCCGAGGTCGGT
CGTGTCGTACCTGAAAACTAATAT -> GTGTCGTACCTGAAAACTAATATC
AGCTCAACCTGCGCAGGACTGAAG -> GCTCAACCTGCGCAGGACTGAAGA
GCCACTGAACAGAGGACTCAGATC -> CCACTGAACAGAGGACTCAGATCT
AGACTGCAAGAAAGTCTTACGAGA -> GACTGCAAGAAAGTCTTACGAGAA
CTCCGGTTTCAGCCACTGAACAGA -> TCCGGTTTCAGCCACTGAACAGAG
GATCTTTCGATATACGGCAGTCGC -> ATCTTTCGATATACGGCAGTCGCA
TCGGCTGTTAGCTCAACCTGCGCA -> CGGCTGTTAGCTCAACCTGCGCAG
CGTGTGCCGTCCCCGTATCTTTCG -> GTGTGCCGTCCCCGTATCTTTCGT
TGGGGTGTGCATCGCCCAAGGGAC -> GGGGTGTGCATCGCCCAAGGGACG
ACGGGTTATTACCCGGTTTTCCAT -> CGGGTTATTACCCGGTTTTCCATC
GAAAAAGTACCGGTAAACATACTT -> AAAAAGTACCGGTAAACATACTTA
GGTGCTACATATCGACACCTGGCA -> GTGCTACATATCGACACCTGGCAG
GTGTAATCATATTCCAACCTTTTT -> TGTAATCATATTCCAACCTTTTTC
AACATATAGATATTGACTATTGTC -> ACATATAGATATTGACTATTGTCC
CTTTCGATATACGGCAGTCGCAAC -> TTTCGATATACGGCAGTCGCAACA
ACGGCAGTCGCAACACCGCAACGA -> CGGCAGTCGCAACACCGCAACGAA
CCGGGATGCGTGTGCCGTCCCCGT -> CGGGATGCGTGTGCCGTCCCCGTA
TGAATAAGGCCTGTTGAATGCTTC -> GAATAAGGCCTGTTGAATGCTTCA
GGAGGACATTGTGCTACATCATTT -> GAGGACATTGTGCTACATCATTTC
TCCGACGTATCCCAAAAGAAGTCC -> CCGACGTATCCCAAAAGAAGTCCG
TGGCATGTCACTGTAGTTGGGGTG -> GGCATGTCACTGTAGTTGGGGTGA
GACATATCAGTGTTTATCTCGTCG -> ACATATCAGTGTTTATCTCGTCGT
TCCGTTCCGACTTCTCAACTATCC -> CCGTTCCGACTTCTCAACTATCCA
ATACCCGGTACACCCTTCCTCTTG -> TACCCGGTACACCCTTCCTCTTGG
CGCTATCAGGTGACTCCTCATTAT -> GCTATCAGGTGACTCCTCATTATA
GTGCTACATATCGACACCTGGCAG -> TGCTACATATCGACACCTGGCAGT
AAAGGATCGGGACCGAAACGGGGC -> AAGGATCGGGACCGAAACGGGGCG
AGAACCCGGCGCGCGTCTGCATAC -> GAACCCGGCGCGCGTCTGCATACG
TTCTATTTTAGTTCCGCAGTCTCG -> TCTATTTTAGTTCCGCAGTCTCGC
AAACGGGGCGTTGTGATTAGGACG -> AACGGGGCGTTGTGATTAGGACGT
TATCCGGTGTAATCATATTCCAAC -> ATCCGGTGTAATCATATTCCAACC
TGATATGATTTGGTCATGGTTCTA -> GATATGATTTGGTCATGGTTCTAT
GCGTGTGCCGTCCCCGTATCTTTC -> CGTGTGCCGTCCCCGTATCTTTCG
GTCCCCAAAAATGTTGGACACTGC -> TCCCCAAAAATGTTGGACACTGCC
TCACGGCAAAAGTTGAAACACAGA -> CACGGCAAAAGTTGAAACACAGAC
TGTTCGCGGTCCATCGCTCCGAAC -> GTTCGCGGTCCATCGCTCCGAACG
CGTCCCACGCCCAATGGCACTCCT -> GTCCCACGCCCAATGGCACTCCTG
TGTCCCCAAAAATGTTGGACACTG -> GTCCCCAAAAATGTTGGACACTGC
ATCGACTATAGGTCAACCCTAGGT -> TCGACTATAGGTCAACCCTAGGTG
GGGAAAATTGGTCAATGTTCGCGG -> GGAAAATTGGTCAATGTTCGCGGT
AACTATCCACTGTGTCACTGAACT -> ACTATCCACTGTGTCACTGAACTC
TTGGCGAGCACTTGAAGTACATGA -> TGGCGAGCACTTGAAGTACATGAT
TGATCATCCAATCATAATGGAGGA -> GATCATCCAATCATAATGGAGGAC
CATACTGCGTCCCACGCCCAATGG -> ATACTGCGTCCCACGCCCAATGGC
TGACTATTGTCCCCAAAAATGTTG -> GACTATTGTCCCCAAAAATGTTGG
ATCTCGGATTACGGCACAGAAGAG -> TCTCGGATTACGGCACAGAAGAGT
GCTATTGCGCAATGCTGTGCCGTT -> CTATTGCGCAATGCTGTGCCGTTC
CTCCTAGCCGATACTACGAAGAGA -> TCCTAGCCGATACTACGAAGAGAG
GATACTGTCTATGAGTAATCTTTA -> ATACTGTCTATGAGTAATCTTTAC
AAAAGTTGAAACACAGACTGCAAG -> AAAGTTGAAACACAGACTGCAAGA
TGGCCATGTCCGTATTTTCACTCG -> GGCCATGTCCGTATTTTCACTCGA
CCCTCCAAAGACCATCGAACTCTG -> CCTCCAAAGACCATCGAACTCTGA
TTTTCCATCGAGAAATCATACGGT -> TTTCCATCGAGAAATCATACGGTT
ATCTTTCGATATACGGCAGTCGCA -> TCTTTCGATATACGGCAGTCGCAA
GCGAGCACTTGAAGTACATGATTC -> CGAGCACTTGAAGTACATGATTCC
GAACCAATTTGCACTCCTAGCCGA -> AACCAATTTGCACTCCTAGCCGAT
AGTTGACATCCGGGATGCGTGTGC -> GTTGACATCCGGGATGCGTGTGCC
TACGGCTAGCATGGCCGATCTTTC -> ACGGCTAGCATGGCCGATCTTTCG
ACGCCCAATGGCACTCCTGGTCTC -> CGCCCAATGGCACTCCTGGTCTCA
CTGGCAGTATTGAGGCTATGAACA -> TGGCAGTATTGAGGCTATGAACAA
GTGGTAAAAGGATCGGGACCGAAA -> TGGTAAAAGGATCGGGACCGAAAC
GCTGCAGTTTGACCCCGTGTCGTA -> CTGCAGTTTGACCCCGTGTCGTAC
GGTTCTCTGCGCTATTGCGCAATG -> GTTCTCTGCGCTATTGCGCAATGC
CGTTGTGATTAGGACGTGGTACCC -> GTTGTGATTAGGACGTGGTACCCT
CATATCCGTTCCGACTTCTCAACT -> ATATCCGTTCCGACTTCTCAACTA
AACCCTCGATGTTTGTACGGGTTA -> ACCCTCGATGTTTGTACGGGTTAT
CACTGAACAGAGGACTCAGATCTC -> ACTGAACAGAGGACTCAGATCTCG
TAGTCAGGGGCAAGTCACACAAAT -> AGTCAGGGGCAAGTCACACAAATG
CACCAATTCGTCCACAAGCTGGGG -> ACCAATTCGTCCACAAGCTGGGGT
ATTGGTCAATGTTCGCGGTCCATC -> TTGGTCAATGTTCGCGGTCCATCG
TAGCCCGCTATCAGGTGACTCCTC -> AGCCCGCTATCAGGTGACTCCTCA
TACACCCTTCCTCTTGGGTCGTCT -> ACACCCTTCCTCTTGGGTCGTCTG
CCCCGTGTCGTACCTGAAAACTAA -> CCCGTGTCGTACCTGAAAACTAAT
TCAACATCAACGAAGTGGGCCACA -> CAACATCAACGAAGTGGGCCACAC
GGATGCGTGTGCCGTCCCCGTATC -> GATGCGTGTGCCGTCCCCGTATCT
CGTATGAATTGGCCATGTCCGTAT -> GTATGAATTGGCCATGTCCGTATT
AAAAGTACCGGTAAACATACTTAG -> AAAGTACCGGTAAACATACTTAGT
ATCACAGGTGCTACTGCCGTCCAG -> TCACAGGTGCTACTGCCGTCCAGA
GAACAACATATAGATATTGACTAT -> AACAACATATAGATATTGACTATT
ACTCCTAGCCGATACTACGAAGAG -> CTCCTAGCCGATACTACGAAGAGA
CGGTAAACATACTTAGTCAGGGGC -> GGTAAACATACTTAGTCAGGGGCA
TCCCAAAAGAAGTCCGATGAGAAA -> CCCAAAAGAAGTCCGATGAGAAAA
ATTTAGCCCGCTATCAGGTGACTC -> TTTAGCCCGCTATCAGGTGACTCC
CGCTTGTGATACTGTCTATGAGTA -> GCTTGTGATACTGTCTATGAGTAA
TCCAGTATGTCCGATTTGTCACTT -> CCAGTATGTCCGATTTGTCACTTC
ACTTATGCCCAACTCCGGGGTTTA -> CTTATGCCCAACTCCGGGGTTTAG
CACCTAGGTCAGGACTATGCTCTT -> ACCTAGGTCAGGACTATGCTCTTA
ACACAGACTGCAAGAAAGTCTTAC -> CACAGACTGCAAGAAAGTCTTACG
TCAGGGGCAAGTCACACAAATGCT -> CAGGGGCAAGTCACACAAATGCTA
AATCCTCAACATCAACGAAGTGGG -> ATCCTCAACATCAACGAAGTGGGC
TAGATATTGACTATTGTCCCCAAA -> AGATATTGACTATTGTCCCCAAAA
AAACACAGACTGCAAGAAAGTCTT -> AACACAGACTGCAAGAAAGTCTTA
ATACTGCGTCCCACGCCCAATGGC -> TACTGCGTCCCACGCCCAATGGCA
CTATTGTCCCCAAAAATGTTGGAC -> TATTGTCCCCAAAAATGTTGGACA
GATATACGGCAGTCGCAACACCGC -> ATATACGGCAGTCGCAACACCGCA
CTGAGAACCGGGGCAGTGGAGGCC -> TGAGAACCGGGGCAGTGGAGGCCT
CTCGTAAGGTGATCTGCGGGGGTT -> TCGTAAGGTGATCTGCGGGGGTTC
GGGGTATTTATCATGGGGTTAGAT -> GGGTATTTATCATGGGGTTAGATC
TAGCATGATGTGACTTATGCCCAA -> AGCATGATGTGACTTATGCCCAAC
AGGTGATCTGCGGGGGTTCTGATA -> GGTGATCTGCGGGGGTTCTGATAT
ATCCCAAAAGAAGTCCGATGAGAA -> TCCCAAAAGAAGTCCGATGAGAAA
TGAGGCCGCGTGGCTGCAGTTTGA -> GAGGCCGCGTGGCTGCAGTTTGAC
ATATCGACACCTGGCAGTATTGAG -> TATCGACACCTGGCAGTATTGAGG
TGTCGCTCGTAAGGTGATCTGCGG -> GTCGCTCGTAAGGTGATCTGCGGG
TAAAAGGTATCCGACGTATCCCAA -> AAAAGGTATCCGACGTATCCCAAA
CCAACTCCGGGGTTTAGATCTATA -> CAACTCCGGGGTTTAGATCTATAT
ATTCCAGAACCAATTTGCACTCCT -> TTCCAGAACCAATTTGCACTCCTA
TTTCGTAAGAGCATACCCCTCGCA -> TTCGTAAGAGCATACCCCTCGCAT
CCGGTAAACATACTTAGTCAGGGG -> CGGTAAACATACTTAGTCAGGGGC
TACATACTGCGTCCCACGCCCAAT -> ACATACTGCGTCCCACGCCCAATG
GTATCTTTCGTAAGAGCATACCCC -> TATCTTTCGTAAGAGCATACCCCT
GAGCACTTGAAGTACATGATTCCA -> AGCACTTGAAGTACATGATTCCAG
TCACTGAACTCGCTGATTGGTCGA -> CACTGAACTCGCTGATTGGTCGAC
GACTCCTTCCTCGCGCAGGTAGCA -> ACTCCTTCCTCGCGCAGGTAGCAT
GCCATAGCCGTAACTAGCGCATTG -> CCATAGCCGTAACTAGCGCATTGG
CCGTATCTTTCGTAAGAGCATACC -> CGTATCTTTCGTAAGAGCATACCC
GGTTCTATTTTAGTTCCGCAGTCT -> GTTCTATTTTAGTTCCGCAGTCTC
GGTATGGGGGGAAAATTGGTCAAT -> GTATGGGGGGAAAATTGGTCAATG
CGTTCATATCCGTTCCGACTTCTC -> GTTCATATCCGTTCCGACTTCTCA
TGGTCTCACAGGCGCTACTTTTAG -> GGTCTCACAGGCGCTACTTTTAGT
ACATCATTTCGGATCACAGGTGCT -> CATCATTTCGGATCACAGGTGCTA
ATAGATATTGACTATTGTCCCCAA -> TAGATATTGACTATTGTCCCCAAA
TAAAAGGATCGGGACCGAAACGGG -> AAAAGGATCGGGACCGAAACGGGG
AATAAGGCCTGTTGAATGCTTCAG -> ATAAGGCCTGTTGAATGCTTCAGT
GCACTTGAAGTACATGATTCCAGA -> CACTTGAAGTACATGATTCCAGAA
CCCCGAGCCTAGTCACGGCAAAAG -> CCCGAGCCTAGTCACGGCAAAAGT
TTCCAACCTTTTTCCAATCCTCAA -> TCCAACCTTTTTCCAATCCTCAAC
ACGTGGTACCCTCCTCGGAACGTC -> CGTGGTACCCTCCTCGGAACGTCA
CGAAACACAATACCGCCGATTGTT -> GAAACACAATACCGCCGATTGTTT
CAGTATTGAGGCTATGAACAACAT -> AGTATTGAGGCTATGAACAACATA
CGGCTAGCATGGCCGATCTTTCGA -> GGCTAGCATGGCCGATCTTTCGAT
CGATGAGAAAAAGTACCGGTAAAC -> GATGAGAAAAAGTACCGGTAAACA
CGACACCTGGCAGTATTGAGGCTA -> GACACCTGGCAGTATTGAGGCTAT
TTATGCCCAACTCCGGGGTTTAGA -> TATGCCCAACTCCGGGGTTTAGAT
AGCATGATGTGACTTATGCCCAAC -> GCATGATGTGACTTATGCCCAACT
TGATTTGGTCATGGTTCTATTTTA -> GATTTGGTCATGGTTCTATTTTAG
GCTAGCATGGCCGATCTTTCGATA -> CTAGCATGGCCGATCTTTCGATAT
GGCTACGGCTTGATGGCATGTCAC -> GCTACGGCTTGATGGCATGTCACT
CGGGGCGTTGTGATTAGGACGTGG -> GGGGCGTTGTGATTAGGACGTGGT
TCAACCCTCGATGTTTGTACGGGT -> CAACCCTCGATGTTTGTACGGGTT
ACCCTAGGTGCTGTAGTTCCGGCC -> CCCTAGGTGCTGTAGTTCCGGCCG
TGCTATAGAACCCGGCGCGCGTCT -> GCTATAGAACCCGGCGCGCGTCTG
ACCGGTGCTACATATCGACACCTG -> CCGGTGCTACATATCGACACCTGG
GCAAGTCACACAAATGCTATAGAA -> CAAGTCACACAAATGCTATAGAAC
ACCCGGCGCGCGTCTGCATACGGC -> CCCGGCGCGCGTCTGCATACGGCT
GGGTATTTATCATGGGGTTAGATC -> GGTATTTATCATGGGGTTAGATCG
CGTTAATTCGTGTATGACAGGCAG -> GTTAATTCGTGTATGACAGGCAGT
TATAGAACCCGGCGCGCGTCTGCA -> ATAGAACCCGGCGCGCGTCTGCAT
CTTGCCCCGAGCCTAGTCACGGCA -> TTGCCCCGAGCCTAGTCACGGCAA
GTTCCGACTTCTCAACTATCCACT -> TTCCGACTTCTCAACTATCCACTG
ATTAGGACGTGGTACCCTCCTCGG -> TTAGGACGTGGTACCCTCCTCGGA
ATATGATTTGGTCATGGTTCTATT -> TATGATTTGGTCATGGTTCTATTT
CGAGCCTAGTCACGGCAAAAGTTG -> GAGCCTAGTCACGGCAAAAGTTGA
TGCTACATATCGACACCTGGCAGT -> GCTACATATCGACACCTGGCAGTA
ATGCCCAACTCCGGGGTTTAGATC -> TGCCCAACTCCGGGGTTTAGATCT
CCATCAACCCTCGATGTTTGTACG -> CATCAACCCTCGATGTTTGTACGG
CGTATTTTCACTCGATTAATTCGG -> GTATTTTCACTCGATTAATTCGGT
GTACTTTACCCCGCAGGTCGGCGG -> TACTTTACCCCGCAGGTCGGCGGA
ACCCGGTTTTCCATCGAGAAATCA -> CCCGGTTTTCCATCGAGAAATCAT
TTTGCACTCCTAGCCGATACTACG -> TTGCACTCCTAGCCGATACTACGA
CACTGTAGTTGGGGTGACATATCA -> ACTGTAGTTGGGGTGACATATCAG
CGCGTAAATACCCGGTACACCCTT -> GCGTAAATACCCGGTACACCCTTC
GTTCTCTGCGCTATTGCGCAATGC -> TTCTCTGCGCTATTGCGCAATGCT
ACTACGAAGAGAGTTCCATTGTCG -> CTACGAAGAGAGTTCCATTGTCGC
AGTTGGGGTGACATATCAGTGTTT -> GTTGGGGTGACATATCAGTGTTTA
CACAGACTGCAAGAAAGTCTTACG -> ACAGACTGCAAGAAAGTCTTACGA
AGGCAGTTCCTAGCATGAGGCCGC -> GGCAGTTCCTAGCATGAGGCCGCG
TCACTGTAGTTGGGGTGACATATC -> CACTGTAGTTGGGGTGACATATCA
TTTAGTCATAGGGTTCTCTGCGCT -> TTAGTCATAGGGTTCTCTGCGCTA
TGCAGTTTGACCCCGTGTCGTACC -> GCAGTTTGACCCCGTGTCGTACCT
TACATGATTCCAGAACCAATTTGC -> ACATGATTCCAGAACCAATTTGCA
CGCTTGAGTTGACATCCGGGATGC -> GCTTGAGTTGACATCCGGGATGCG
GGCTAGATGTACTTCGCGCATGGC -> GCTAGATGTACTTCGCGCATGGCG
TCGTCGTCGGTCGCGTACTGACTC -> CGTCGTCGGTCGCGTACTGACTCC
CGGATTACGGCACAGAAGAGTAGT -> GGATTACGGCACAGAAGAGTAGTC
GATCGACTATAGGTCAACCCTAGG -> ATCGACTATAGGTCAACCCTAGGT
CAGTTCCTAGCATGAGGCCGCGTG -> AGTTCCTAGCATGAGGCCGCGTGG
AGATCGACTATAGGTCAACCCTAG -> GATCGACTATAGGTCAACCCTAGG
GTCCCCGTATCTTTCGTAAGAGCA -> TCCCCGTATCTTTCGTAAGAGCAT
GGTGCCTGCCTTAGCGCAGATCTC -> GTGCCTGCCTTAGCGCAGATCTCA
TCCGGCCGAGGTCGGTGGTAAAAG -> CCGGCCGAGGTCGGTGGTAAAAGG
GTCAATGTTCGCGGTCCATCGCTC -> TCAATGTTCGCGGTCCATCGCTCC
ATCCAGTATGTCCGATTTGTCACT -> TCCAGTATGTCCGATTTGTCACTT
TATCGACACCTGGCAGTATTGAGG -> ATCGACACCTGGCAGTATTGAGGC
CATTGTGCTACATCATTTCGGATC -> ATTGTGCTACATCATTTCGGATCA
AGAAGAGTAGTCCCCTCCAAAGAC -> GAAGAGTAGTCCCCTCCAAAGACC
GAATAAGGCCTGTTGAATGCTTCA -> AATAAGGCCTGTTGAATGCTTCAG
TCGCGCAGGTAGCATGATGTGACT -> CGCGCAGGTAGCATGATGTGACTT
TCACATGCCTTGTCTTGGCGAGCA -> CACATGCCTTGTCTTGGCGAGCAC
CGTCCAGACCATGGAGCATTTGCG -> GTCCAGACCATGGAGCATTTGCGT
TTTGACCCCGTGTCGTACCTGAAA -> TTGACCCCGTGTCGTACCTGAAAA
TTATCTCGTCGTCGGTCGCGTACT -> TATCTCGTCGTCGGTCGCGTACTG
TACATCATTTCGGATCACAGGTGC -> ACATCATTTCGGATCACAGGTGCT
CCCGGTACACCCTTCCTCTTGGGT -> CCGGTACACCCTTCCTCTTGGGTC
GATTAATTCGGTGCCTGCCTTAGC -> ATTAATTCGGTGCCTGCCTTAGCG
TGTCTATGAGTAATCTTTACCTCT -> GTCTATGAGTAATCTTTACCTCTA
AACAGAGGACTCAGATCTCGGATT -> ACAGAGGACTCAGATCTCGGATTA
ATGGCACTCCTGGTCTCACAGGCG -> TGGCACTCCTGGTCTCACAGGCGC
TGCTGTGCCGTTCGGAAGTCTCTG -> GCTGTGCCGTTCGGAAGTCTCTGG
AGGGGCAAGTCACACAAATGCTAT -> GGGGCAAGTCACACAAATGCTATA
GACCGAAACGGGGCGTTGTGATTA -> ACCGAAACGGGGCGTTGTGATTAG
ACCTGGCAGTATTGAGGCTATGAA -> CCTGGCAGTATTGAGGCTATGAAC
ACACCAATTCGTCCACAAGCTGGG -> CACCAATTCGTCCACAAGCTGGGG
TCCGCAGTCTCGCTGGACCCTTGG -> CCGCAGTCTCGCTGGACCCTTGGC
ATATCAGTGTTTATCTCGTCGTCG -> TATCAGTGTTTATCTCGTCGTCGG
CTCCGGGGTTTAGATCTATATCGT -> TCCGGGGTTTAGATCTATATCGTT
GAGGCCGCGTGGCTGCAGTTTGAC -> AGGCCGCGTGGCTGCAGTTTGACC
GTGACTTATGCCCAACTCCGGGGT -> TGACTTATGCCCAACTCCGGGGTT
CCCGCTATCAGGTGACTCCTCATT -> CCGCTATCAGGTGACTCCTCATTA
TGCGTGTGCCGTCCCCGTATCTTT -> GCGTGTGCCGTCCCCGTATCTTTC
TTACGGCACAGAAGAGTAGTCCCC -> TACGGCACAGAAGAGTAGTCCCCT
TCTGCGCTATTGCGCAATGCTGTG -> CTGCGCTATTGCGCAATGCTGTGC
CCGATTTGTCACTTCGAGAATGGC -> CGATTTGTCACTTCGAGAATGGCT
AGAGTAGTCCCCTCCAAAGACCAT -> GAGTAGTCCCCTCCAAAGACCATC
TAGCGCAGATCTCACATGCCTTGT -> AGCGCAGATCTCACATGCCTTGTC
GGCCACACCAATTCGTCCACAAGC -> GCCACACCAATTCGTCCACAAGCT
GATTGGTCGACCGAGATATCGCTT -> ATTGGTCGACCGAGATATCGCTTG
TACCGGTAAACATACTTAGTCAGG -> ACCGGTAAACATACTTAGTCAGGG
CCTAGGTCAGGACTATGCTCTTAG -> CTAGGTCAGGACTATGCTCTTAGG
GTACACCCTTCCTCTTGGGTCGTC -> TACACCCTTCCTCTTGGGTCGTCT
TGGGTATGGGGGGAAAATTGGTCA -> GGGTATGGGGGGAAAATTGGTCAA
CGGTGCTACATATCGACACCTGGC -> GGTGCTACATATCGACACCTGGCA
ACTGTAGTTGGGGTGACATATCAG -> CTGTAGTTGGGGTGACATATCAGT
GTATCCCAAAAGAAGTCCGATGAG -> TATCCCAAAAGAAGTCCGATGAGA
AAAAGGATCGGGACCGAAACGGGG -> AAAGGATCGGGACCGAAACGGGGC
GGTATTTATCATGGGGTTAGATCG -> GTATTTATCATGGGGTTAGATCGA
CCAACCTTTTTCCAATCCTCAACA -> CAACCTTTTTCCAATCCTCAACAT
TTCCTCTTGGGTCGTCTGAACTAC -> TCCTCTTGGGTCGTCTGAACTACT
AGACCGATCGGCTGTTAGCTCAAC -> GACCGATCGGCTGTTAGCTCAACC
CTCCTCATTATAAAAGGTATCCGA -> TCCTCATTATAAAAGGTATCCGAC
GTCAGGGGCAAGTCACACAAATGC -> TCAGGGGCAAGTCACACAAATGCT
TATTGTCCCCAAAAATGTTGGACA -> ATTGTCCCCAAAAATGTTGGACAC
CTTAGTCAGGGGCAAGTCACACAA -> TTAGTCAGGGGCAAGTCACACAAA
TTTATCATGGGGTTAGATCGACTA -> TTATCATGGGGTTAGATCGACTAT
GTCTTACGAGAAACTATTAGGCTA -> TCTTACGAGAAACTATTAGGCTAC
TACGGCACAGAAGAGTAGTCCCCT -> ACGGCACAGAAGAGTAGTCCCCTC
AACTCGCTGATTGGTCGACCGAGA -> ACTCGCTGATTGGTCGACCGAGAT
ACCCTTCCTCTTGGGTCGTCTGAA -> CCCTTCCTCTTGGGTCGTCTGAAC
ACCGACCGGTGCTACATATCGACA -> CCGACCGGTGCTACATATCGACAC
CAGTCTCGCTGGACCCTTGGCCAT -> AGTCTCGCTGGACCCTTGGCCATA
TTACCTCTACATTCGTCTTGCCCC -> TACCTCTACATTCGTCTTGCCCCG
ACCCCGTGTCGTACCTGAAAACTA -> CCCCGTGTCGTACCTGAAAACTAA
ACCGAGATATCGCTTGTGATACTG -> CCGAGATATCGCTTGTGATACTGT
ACTCCTCATTATAAAAGGTATCCG -> CTCCTCATTATAAAAGGTATCCGA
CTGCATACGGCTAGCATGGCCGAT -> TGCATACGGCTAGCATGGCCGATC
ATGGGGTTAGATCGACTATAGGTC -> TGGGGTTAGATCGACTATAGGTCA
TTAGACCGATCGGCTGTTAGCTCA -> TAGACCGATCGGCTGTTAGCTCAA
TCTGAAGCTCCAAACGTACTTTAC -> CTGAAGCTCCAAACGTACTTTACC
CCTCTTGGGTCGTCTGAACTACTG -> CTCTTGGGTCGTCTGAACTACTGA
TGATGTGACTTATGCCCAACTCCG -> GATGTGACTTATGCCCAACTCCGG
GAGTAGTCCCCTCCAAAGACCATC -> AGTAGTCCCCTCCAAAGACCATCG
GCTGGGGTGTGCATCGCCCAAGGG -> CTGGGGTGTGCATCGCCCAAGGGA
GTTTCAGCCACTGAACAGAGGACT -> TTTCAGCCACTGAACAGAGGACTC
AGTTCCTAGCATGAGGCCGCGTGG -> GTTCCTAGCATGAGGCCGCGTGGC
GCCTATAACAACCAATTTAGCCCG -> CCTATAACAACCAATTTAGCCCGC
TTTAGATCTATATCGTTAATTCGT -> TTAGATCTATATCGTTAATTCGTG
CCGGTACACCCTTCCTCTTGGGTC -> CGGTACACCCTTCCTCTTGGGTCG
ATGTATCGACGCGTAAATACCCGG -> TGTATCGACGCGTAAATACCCGGT
TTAGGCTACGGCTTGATGGCATGT -> TAGGCTACGGCTTGATGGCATGTC
AGTCCCCTCCAAAGACCATCGAAC -> GTCCCCTCCAAAGACCATCGAACT
GTCCGATGAGAAAAAGTACCGGTA -> TCCGATGAGAAAAAGTACCGGTAA
GCATTGGACGCTGATTTCGCTTGA -> CATTGGACGCTGATTTCGCTTGAG
TGAAGCTCCAAACGTACTTTACCC -> GAAGCTCCAAACGTACTTTACCCC
CGATTAATTCGGTGCCTGCCTTAG -> GATTAATTCGGTGCCTGCCTTAGC
GACGTATCCCAAAAGAAGTCCGAT -> ACGTATCCCAAAAGAAGTCCGATG
TATCGACGCGTAAATACCCGGTAC -> ATCGACGCGTAAATACCCGGTACA
CTCCTCGGAACGTCACGAGAATGA -> TCCTCGGAACGTCACGAGAATGAT
AGTTCCATTGTCGCTCGTAAGGTG -> GTTCCATTGTCGCTCGTAAGGTGA
GACCGGTGCTACATATCGACACCT -> ACCGGTGCTACATATCGACACCTG
TGCGGGGGTTCTGATATGATTTGG -> GCGGGGGTTCTGATATGATTTGGT
GACCGAGATATCGCTTGTGATACT -> ACCGAGATATCGCTTGTGATACTG
CCCGCAGGTCGGCGGATTTGACAG -> CCGCAGGTCGGCGGATTTGACAGC
TAAGAGCATACCCCTCGCATGTAT -> AAGAGCATACCCCTCGCATGTATC
TCAGGTGACTCCTCATTATAAAAG -> CAGGTGACTCCTCATTATAAAAGG
TCTCTGGGGGTATTTATCATGGGG -> CTCTGGGGGTATTTATCATGGGGT
GGCAGTGGAGGCCTATAACAACCA -> GCAGTGGAGGCCTATAACAACCAA
GATCTGCGGGGGTTCTGATATGAT -> ATCTGCGGGGGTTCTGATATGATT
GAATGATCATCCAATCATAATGGA -> AATGATCATCCAATCATAATGGAG
AATATCCGGTGTAATCATATTCCA -> ATATCCGGTGTAATCATATTCCAA
CCTCTACATTCGTCTTGCCCCGAG -> CTCTACATTCGTCTTGCCCCGAGC
CTATAGAACCCGGCGCGCGTCTGC -> TATAGAACCCGGCGCGCGTCTGCA
TACCCCTCGCATGTATCGACGCGT -> ACCCCTCGCATGTATCGACGCGTA
GAGAAACTATTAGGCTACGGCTTG -> AGAAACTATTAGGCTACGGCTTGA
CGGGTTATTACCCGGTTTTCCATC -> GGGTTATTACCCGGTTTTCCATCG
TTCTCTGCGCTATTGCGCAATGCT -> TCTCTGCGCTATTGCGCAATGCTG
CGAGGTCGGTGGTAAAAGGATCGG -> GAGGTCGGTGGTAAAAGGATCGGG
AAAGACCATCGAACTCTGAAGCTC -> AAGACCATCGAACTCTGAAGCTCC
ACAACATATAGATATTGACTATTG -> CAACATATAGATATTGACTATTGT
TGGCTGCAGTTTGACCCCGTGTCG -> GGCTGCAGTTTGACCCCGTGTCGT
ACACAATACCGCCGATTGTTTACA -> CACAATACCGCCGATTGTTTACAT
TGGAGCATTTGCGTTACACGTACC -> GGAGCATTTGCGTTACACGTACCG
GAATGGCTCCGGTTTCAGCCACTG -> AATGGCTCCGGTTTCAGCCACTGA
TGTTAGCTCAACCTGCGCAGGACT -> GTTAGCTCAACCTGCGCAGGACTG
TGTGATACTGTCTATGAGTAATCT -> GTGATACTGTCTATGAGTAATCTT
ACCCTCGATGTTTGTACGGGTTAT -> CCCTCGATGTTTGTACGGGTTATT
TCGGTGCCTGCCTTAGCGCAGATC -> CGGTGCCTGCCTTAGCGCAGATCT
GAGCCTAGTCACGGCAAAAGTTGA -> AGCCTAGTCACGGCAAAAGTTGAA
CTTCGCGCATGGCGTTCATATCCG -> TTCGCGCATGGCGTTCATATCCGT
TCTTACGAGAAACTATTAGGCTAC -> CTTACGAGAAACTATTAGGCTACG
TCCTCGGAACGTCACGAGAATGAT -> CCTCGGAACGTCACGAGAATGATC
TCGTACCTGAAAACTAATATCCGG -> CGTACCTGAAAACTAATATCCGGT
TTCGGTGCCTGCCTTAGCGCAGAT -> TCGGTGCCTGCCTTAGCGCAGATC
ATTATAAAAGGTATCCGACGTATC -> TTATAAAAGGTATCCGACGTATCC
AACAACATATAGATATTGACTATT -> ACAACATATAGATATTGACTATTG
AATTCGTGTATGACAGGCAGTTCC -> ATTCGTGTATGACAGGCAGTTCCT
TGTGATTAGGACGTGGTACCCTCC -> GTGATTAGGACGTGGTACCCTCCT
AGAACCGGGGCAGTGGAGGCCTAT -> GAACCGGGGCAGTGGAGGCCTATA
GTAGTTCCGGCCGAGGTCGGTGGT -> TAGTTCCGGCCGAGGTCGGTGGTA
TTTAGCCCGCTATCAGGTGACTCC -> TTAGCCCGCTATCAGGTGACTCCT
GAACCGGGGCAGTGGAGGCCTATA -> AACCGGGGCAGTGGAGGCCTATAA
CGTACCTGAAAACTAATATCCGGT -> GTACCTGAAAACTAATATCCGGTG
ATTGACTATTGTCCCCAAAAATGT -> TTGACTATTGTCCCCAAAAATGTT
TCTCTGCGCTATTGCGCAATGCTG -> CTCTGCGCTATTGCGCAATGCTGT
ATTTATCATGGGGTTAGATCGACT -> TTTATCATGGGGTTAGATCGACTA
TTAGGCTGGCTAGATGTACTTCGC -> TAGGCTGGCTAGATGTACTTCGCG
GCTTGTGATACTGTCTATGAGTAA -> CTTGTGATACTGTCTATGAGTAAT
CTTGTGATACTGTCTATGAGTAAT -> TTGTGATACTGTCTATGAGTAATC
ACAGGCAGTTCCTAGCATGAGGCC -> CAGGCAGTTCCTAGCATGAGGCCG
GGGTGACATATCAGTGTTTATCTC -> GGTGACATATCAGTGTTTATCTCG
TTCGGAAGTCTCTGGGGGTATTTA -> TCGGAAGTCTCTGGGGGTATTTAT
GCTATCAGGTGACTCCTCATTATA -> CTATCAGGTGACTCCTCATTATAA
GCAATGCTGTGCCGTTCGGAAGTC -> CAATGCTGTGCCGTTCGGAAGTCT
ACTGCCGTCCAGACCATGGAGCAT -> CTGCCGTCCAGACCATGGAGCATT
GTTCCGGCCGAGGTCGGTGGTAAA -> TTCCGGCCGAGGTCGGTGGTAAAA
CAAATGCTATAGAACCCGGCGCGC -> AAATGCTATAGAACCCGGCGCGCG
GGTTCTGATATGATTTGGTCATGG -> GTTCTGATATGATTTGGTCATGGT
AGTATTGAGGCTATGAACAACATA -> GTATTGAGGCTATGAACAACATAT
CGCGCGTCTGCATACGGCTAGCAT -> GCGCGTCTGCATACGGCTAGCATG
ATCTATATCGTTAATTCGTGTATG -> TCTATATCGTTAATTCGTGTATGA
GCTCCGAACGTCCATCAACCCTCG -> CTCCGAACGTCCATCAACCCTCGA
AGGTCGGTGGTAAAAGGATCGGGA -> GGTCGGTGGTAAAAGGATCGGGAC
TGACTCCTTCCTCGCGCAGGTAGC -> GACTCCTTCCTCGCGCAGGTAGCA
GAGAAAAAGTACCGGTAAACATAC -> AGAAAAAGTACCGGTAAACATACT
TGTCCGTATTTTCACTCGATTAAT -> GTCCGTATTTTCACTCGATTAATT
CCGCTATCAGGTGACTCCTCATTA -> CGCTATCAGGTGACTCCTCATTAT
CTAGATGTACTTCGCGCATGGCGT -> TAGATGTACTTCGCGCATGGCGTT
TCCGATTTGTCACTTCGAGAATGG -> CCGATTTGTCACTTCGAGAATGGC
CCAAACGTACTTTACCCCGCAGGT -> CAAACGTACTTTACCCCGCAGGTC
GAACTCGCTGATTGGTCGACCGAG -> AACTCGCTGATTGGTCGACCGAGA
ATATTCCAACCTTTTTCCAATCCT -> TATTCCAACCTTTTTCCAATCCTC
GATTTCGCTTGAGTTGACATCCGG -> ATTTCGCTTGAGTTGACATCCGGG
CGTACCGACCGGTGCTACATATCG -> GTACCGACCGGTGCTACATATCGA
TGAGTAATCTTTACCTCTACATTC -> GAGTAATCTTTACCTCTACATTCG
ATTGAGGCTATGAACAACATATAG -> TTGAGGCTATGAACAACATATAGA
TTCCAGAACCAATTTGCACTCCTA -> TCCAGAACCAATTTGCACTCCTAG
CAACCAATTTAGCCCGCTATCAGG -> AACCAATTTAGCCCGCTATCAGGT
TGTCGTACCTGAAAACTAATATCC -> GTCGTACCTGAAAACTAATATCCG
CACGTACCGACCGGTGCTACATAT -> ACGTACCGACCGGTGCTACATATC
CCAATCCTCAACATCAACGAAGTG -> CAATCCTCAACATCAACGAAGTGG
GTACCTGAAAACTAATATCCGGTG -> TACCTGAAAACTAATATCCGGTGT
GTGTGCATCGCCCAAGGGACGTAT -> TGTGCATCGCCCAAGGGACGTATG
CCACCTAGGTCAGGACTATGCTCT -> CACCTAGGTCAGGACTATGCTCTT
TCAGGACTATGCTCTTAGGCTGGC -> CAGGACTATGCTCTTAGGCTGGCT
TGTCACTGAACTCGCTGATTGGTC -> GTCACTGAACTCGCTGATTGGTCG
ACTACTGAGAACCGGGGCAGTGGA -> CTACTGAGAACCGGGGCAGTGGAG
ACGAAACACAATACCGCCGATTGT -> CGAAACACAATACCGCCGATTGTT
AGCGCAGATCTCACATGCCTTGTC -> GCGCAGATCTCACATGCCTTGTCT
CGATATACGGCAGTCGCAACACCG -> GATATACGGCAGTCGCAACACCGC
GTGCATCGCCCAAGGGACGTATGA -> TGCATCGCCCAAGGGACGTATGAA
GTTCTATCCAGTATGTCCGATTTG -> TTCTATCCAGTATGTCCGATTTGT
ACCCCTCGCATGTATCGACGCGTA -> CCCCTCGCATGTATCGACGCGTAA
TCGCATGTATCGACGCGTAAATAC -> CGCATGTATCGACGCGTAAATACC
TACGGGTTATTACCCGGTTTTCCA -> ACGGGTTATTACCCGGTTTTCCAT
AGTCTGGGTATGGGGGGAAAATTG -> GTCTGGGTATGGGGGGAAAATTGG
TCGACCGAGATATCGCTTGTGATA -> CGACCGAGATATCGCTTGTGATAC
TTCAGCCACTGAACAGAGGACTCA -> TCAGCCACTGAACAGAGGACTCAG
AGTCACGGCAAAAGTTGAAACACA -> GTCACGGCAAAAGTTGAAACACAG
CTGCGTCCCACGCCCAATGGCACT -> TGCGTCCCACGCCCAATGGCACTC
TATGAATTGGCCATGTCCGTATTT -> ATGAATTGGCCATGTCCGTATTTT
AAAGGTATCCGACGTATCCCAAAA -> AAGGTATCCGACGTATCCCAAAAG
AAAAAGTACCGGTAAACATACTTA -> AAAAGTACCGGTAAACATACTTAG
GACTTATGCCCAACTCCGGGGTTT -> ACTTATGCCCAACTCCGGGGTTTA
GGTGTGCATCGCCCAAGGGACGTA -> GTGTGCATCGCCCAAGGGACGTAT
CGGGGGTTCTGATATGATTTGGTC -> GGGGGTTCTGATATGATTTGGTCA
GTTGTGATTAGGACGTGGTACCCT -> TTGTGATTAGGACGTGGTACCCTC
TGGGTCGTCTGAACTACTGAGAAC -> GGGTCGTCTGAACTACTGAGAACC
TTTTAGTTCCGCAGTCTCGCTGGA -> TTTAGTTCCGCAGTCTCGCTGGAC
AACTAATATCCGGTGTAATCATAT -> ACTAATATCCGGTGTAATCATATT
GAGTTGACATCCGGGATGCGTGTG -> AGTTGACATCCGGGATGCGTGTGC
ATACCGCCGATTGTTTACATACTG -> TACCGCCGATTGTTTACATACTGC
GTGGAGGCCTATAACAACCAATTT -> TGGAGGCCTATAACAACCAATTTA
CGGTGGTAAAAGGATCGGGACCGA -> GGTGGTAAAAGGATCGGGACCGAA
CTTCTCAACTATCCACTGTGTCAC -> TTCTCAACTATCCACTGTGTCACT
TGAGTTGACATCCGGGATGCGTGT -> GAGTTGACATCCGGGATGCGTGTG
CTGAAAACTAATATCCGGTGTAAT -> TGAAAACTAATATCCGGTGTAATC
TCTTTCGTAAGAGCATACCCCTCG -> CTTTCGTAAGAGCATACCCCTCGC
TACTGACTCCTTCCTCGCGCAGGT -> ACTGACTCCTTCCTCGCGCAGGTA
TCATATTCCAACCTTTTTCCAATC -> CATATTCCAACCTTTTTCCAATCC
TGTATGACAGGCAGTTCCTAGCAT -> GTATGACAGGCAGTTCCTAGCATG
GCGTTCATATCCGTTCCGACTTCT -> CGTTCATATCCGTTCCGACTTCTC
CAGTGTTTATCTCGTCGTCGGTCG -> AGTGTTTATCTCGTCGTCGGTCGC
GTCTCTGGGGGTATTTATCATGGG -> TCTCTGGGGGTATTTATCATGGGG
ATGAGTAATCTTTACCTCTACATT -> TGAGTAATCTTTACCTCTACATTC
ATTCGTGTATGACAGGCAGTTCCT -> TTCGTGTATGACAGGCAGTTCCTA
CGGAAGTCTCTGGGGGTATTTATC -> GGAAGTCTCTGGGGGTATTTATCA
GGGTTTAGATCTATATCGTTAATT -> GGTTTAGATCTATATCGTTAATTC
ATCGACACCTGGCAGTATTGAGGC -> TCGACACCTGGCAGTATTGAGGCT
ATGTCACTGTAGTTGGGGTGACAT -> TGTCACTGTAGTTGGGGTGACATA
CCACACCAATTCGTCCACAAGCTG -> CACACCAATTCGTCCACAAGCTGG
ACCATGGAGCATTTGCGTTACACG -> CCATGGAGCATTTGCGTTACACGT
GCGGATTTGACAGCCACCTAGGTC -> CGGATTTGACAGCCACCTAGGTCA
CCTCGATGTTTGTACGGGTTATTA -> CTCGATGTTTGTACGGGTTATTAC
GACCGATCGGCTGTTAGCTCAACC -> ACCGATCGGCTGTTAGCTCAACCT
TAAATACCCGGTACACCCTTCCTC -> AAATACCCGGTACACCCTTCCTCT
AGGTGCTACTGCCGTCCAGACCAT -> GGTGCTACTGCCGTCCAGACCATG
TAGGCTGGCTAGATGTACTTCGCG -> AGGCTGGCTAGATGTACTTCGCGC
TTGAGTTGACATCCGGGATGCGTG -> TGAGTTGACATCCGGGATGCGTGT
CGCGCAGGTAGCATGATGTGACTT -> GCGCAGGTAGCATGATGTGACTTA
AGAATGATCATCCAATCATAATGG -> GAATGATCATCCAATCATAATGGA
CTTCGAGAATGGCTCCGGTTTCAG -> TTCGAGAATGGCTCCGGTTTCAGC
GACAAGTCTGGGTATGGGGGGAAA -> ACAAGTCTGGGTATGGGGGGAAAA
ACGTACTTTACCCCGCAGGTCGGC -> CGTACTTTACCCCGCAGGTCGGCG
GTGGGCCACACCAATTCGTCCACA -> TGGGCCACACCAATTCGTCCACAA
GGTCCATCGCTCCGAACGTCCATC -> GTCCATCGCTCCGAACGTCCATCA
AGTAGTCCCCTCCAAAGACCATCG -> GTAGTCCCCTCCAAAGACCATCGA
GTCTCACAGGCGCTACTTTTAGTC -> TCTCACAGGCGCTACTTTTAGTCA
GTTGGGGTGACATATCAGTGTTTA -> TTGGGGTGACATATCAGTGTTTAT
TTCCTAGCATGAGGCCGCGTGGCT -> TCCTAGCATGAGGCCGCGTGGCTG
GTGCTACTGCCGTCCAGACCATGG -> TGCTACTGCCGTCCAGACCATGGA
GAACTACTGAGAACCGGGGCAGTG -> AACTACTGAGAACCGGGGCAGTGG
GAGAGTTCCATTGTCGCTCGTAAG -> AGAGTTCCATTGTCGCTCGTAAGG
GCTACATCATTTCGGATCACAGGT -> CTACATCATTTCGGATCACAGGTG
GTCCATCGCTCCGAACGTCCATCA -> TCCATCGCTCCGAACGTCCATCAA
CAATCATAATGGAGGACATTGTGC -> AATCATAATGGAGGACATTGTGCT
CGCATTGGACGCTGATTTCGCTTG -> GCATTGGACGCTGATTTCGCTTGA
TATAACAACCAATTTAGCCCGCTA -> ATAACAACCAATTTAGCCCGCTAT
TTGTCACTTCGAGAATGGCTCCGG -> TGTCACTTCGAGAATGGCTCCGGT
AGGCCTATAACAACCAATTTAGCC -> GGCCTATAACAACCAATTTAGCCC
GTAAGAGCATACCCCTCGCATGTA -> TAAGAGCATACCCCTCGCATGTAT
TTGGTCGACCGAGATATCGCTTGT -> TGGTCGACCGAGATATCGCTTGTG
GCGCTACTTTTAGTCATAGGGTTC -> CGCTACTTTTAGTCATAGGGTTCT
CCGACCGGTGCTACATATCGACAC -> CGACCGGTGCTACATATCGACACC
CCGTCCAGACCATGGAGCATTTGC -> CGTCCAGACCATGGAGCATTTGCG
CCTTTTTCCAATCCTCAACATCAA -> CTTTTTCCAATCCTCAACATCAAC
TCAATGTTCGCGGTCCATCGCTCC -> CAATGTTCGCGGTCCATCGCTCCG
CAGTGGAGGCCTATAACAACCAAT -> AGTGGAGGCCTATAACAACCAATT
CTCTGAAGCTCCAAACGTACTTTA -> TCTGAAGCTCCAAACGTACTTTAC
TTTGCGTTACACGTACCGACCGGT -> TTGCGTTACACGTACCGACCGGTG
AGGACTCAGATCTCGGATTACGGC -> GGACTCAGATCTCGGATTACGGCA
TTGACAGCCACCTAGGTCAGGACT -> TGACAGCCACCTAGGTCAGGACTA
CGACGTATCCCAAAAGAAGTCCGA -> GACGTATCCCAAAAGAAGTCCGAT
AGAATGGCTCCGGTTTCAGCCACT -> GAATGGCTCCGGTTTCAGCCACTG
CGACCGAGATATCGCTTGTGATAC -> GACCGAGATATCGCTTGTGATACT
CCGATGAGAAAAAGTACCGGTAAA -> CGATGAGAAAAAGTACCGGTAAAC
ATTGGTCGACCGAGATATCGCTTG -> TTGGTCGACCGAGATATCGCTTGT
ACAAGTCTGGGTATGGGGGGAAAA -> CAAGTCTGGGTATGGGGGGAAAAT
CCTAGCCGATACTACGAAGAGAGT -> CTAGCCGATACTACGAAGAGAGTT
GCTATAGAACCCGGCGCGCGTCTG -> CTATAGAACCCGGCGCGCGTCTGC
AGTATGTCCGATTTGTCACTTCGA -> GTATGTCCGATTTGTCACTTCGAG
CGGAACGTCACGAGAATGATCATC -> GGAACGTCACGAGAATGATCATCC
CCGATACTACGAAGAGAGTTCCAT -> CGATACTACGAAGAGAGTTCCATT
TGATGGCATGTCACTGTAGTTGGG -> GATGGCATGTCACTGTAGTTGGGG
ATCCGTTCCGACTTCTCAACTATC -> TCCGTTCCGACTTCTCAACTATCC
TCTTGGGTCGTCTGAACTACTGAG -> CTTGGGTCGTCTGAACTACTGAGA
ATGGCGTTCATATCCGTTCCGACT -> TGGCGTTCATATCCGTTCCGACTT
GAACCCGGCGCGCGTCTGCATACG -> AACCCGGCGCGCGTCTGCATACGG
GACGTGGTACCCTCCTCGGAACGT -> ACGTGGTACCCTCCTCGGAACGTC
GTTTTCCATCGAGAAATCATACGG -> TTTTCCATCGAGAAATCATACGGT
GCGGTCCATCGCTCCGAACGTCCA -> CGGTCCATCGCTCCGAACGTCCAT
TTTTAGTCATAGGGTTCTCTGCGC -> TTTAGTCATAGGGTTCTCTGCGCT
ATCCGACGTATCCCAAAAGAAGTC -> TCCGACGTATCCCAAAAGAAGTCC
CTTTCGTAAGAGCATACCCCTCGC -> TTTCGTAAGAGCATACCCCTCGCA
CTGTTAGCTCAACCTGCGCAGGAC -> TGTTAGCTCAACCTGCGCAGGACT
TACTGCCGTCCAGACCATGGAGCA -> ACTGCCGTCCAGACCATGGAGCAT
GTGTATGACAGGCAGTTCCTAGCA -> TGTATGACAGGCAGTTCCTAGCAT
ATGAACAACATATAGATATTGACT -> TGAACAACATATAGATATTGACTA
TAATGGAGGACATTGTGCTACATC -> AATGGAGGACATTGTGCTACATCA
GTCCAGACCATGGAGCATTTGCGT -> TCCAGACCATGGAGCATTTGCGTT
CAGCCACCTAGGTCAGGACTATGC -> AGCCACCTAGGTCAGGACTATGCT
GATATTGACTATTGTCCCCAAAAA -> ATATTGACTATTGTCCCCAAAAAT
TAGCATGGCCGATCTTTCGATATA -> AGCATGGCCGATCTTTCGATATAC
TACTACGAAGAGAGTTCCATTGTC -> ACTACGAAGAGAGTTCCATTGTCG
GTCACTGAACTCGCTGATTGGTCG -> TCACTGAACTCGCTGATTGGTCGA
ACTAGCGCATTGGACGCTGATTTC -> CTAGCGCATTGGACGCTGATTTCG
TTAGATCTATATCGTTAATTCGTG -> TAGATCTATATCGTTAATTCGTGT
CTCCTGGTCTCACAGGCGCTACTT -> TCCTGGTCTCACAGGCGCTACTTT
GATTAGGACGTGGTACCCTCCTCG -> ATTAGGACGTGGTACCCTCCTCGG
GCCGTAACTAGCGCATTGGACGCT -> CCGTAACTAGCGCATTGGACGCTG
GTCGCTCGTAAGGTGATCTGCGGG -> TCGCTCGTAAGGTGATCTGCGGGG
CCCACGCCCAATGGCACTCCTGGT -> CCACGCCCAATGGCACTCCTGGTC
GACTATAGGTCAACCCTAGGTGCT -> ACTATAGGTCAACCCTAGGTGCTG
CAAGTCACACAAATGCTATAGAAC -> AAGTCACACAAATGCTATAGAACC
TGGCGTTCATATCCGTTCCGACTT -> GGCGTTCATATCCGTTCCGACTTC
CCCTCCTCGGAACGTCACGAGAAT -> CCTCCTCGGAACGTCACGAGAATG
TGAACTACTGAGAACCGGGGCAGT -> GAACTACTGAGAACCGGGGCAGTG
TACGAGAAACTATTAGGCTACGGC -> ACGAGAAACTATTAGGCTACGGCT
GTCATGGTTCTATTTTAGTTCCGC -> TCATGGTTCTATTTTAGTTCCGCA
GACTCCTCATTATAAAAGGTATCC -> ACTCCTCATTATAAAAGGTATCCG
TACTTTACCCCGCAGGTCGGCGGA -> ACTTTACCCCGCAGGTCGGCGGAT
TACTTAGTCAGGGGCAAGTCACAC -> ACTTAGTCAGGGGCAAGTCACACA
GCAGTCTCGCTGGACCCTTGGCCA -> CAGTCTCGCTGGACCCTTGGCCAT
GGACGTGGTACCCTCCTCGGAACG -> GACGTGGTACCCTCCTCGGAACGT
GTTCATATCCGTTCCGACTTCTCA -> TTCATATCCGTTCCGACTTCTCAA
AGATATTGACTATTGTCCCCAAAA -> GATATTGACTATTGTCCCCAAAAA
TATCTCGTCGTCGGTCGCGTACTG -> ATCTCGTCGTCGGTCGCGTACTGA
CGCATGTATCGACGCGTAAATACC -> GCATGTATCGACGCGTAAATACCC
TTGGACGCTGATTTCGCTTGAGTT -> TGGACGCTGATTTCGCTTGAGTTG
GAAGAGAGTTCCATTGTCGCTCGT -> AAGAGAGTTCCATTGTCGCTCGTA
CTAGCATGAGGCCGCGTGGCTGCA -> TAGCATGAGGCCGCGTGGCTGCAG
TCACTCGATTAATTCGGTGCCTGC -> CACTCGATTAATTCGGTGCCTGCC
CAACATATAGATATTGACTATTGT -> AACATATAGATATTGACTATTGTC
ATTTTCACTCGATTAATTCGGTGC -> TTTTCACTCGATTAATTCGGTGCC
AGTCTCGCTGGACCCTTGGCCATA -> GTCTCGCTGGACCCTTGGCCATAG
CAATTCGTCCACAAGCTGGGGTGT -> AATTCGTCCACAAGCTGGGGTGTG
TGTTTGTACGGGTTATTACCCGGT -> GTTTGTACGGGTTATTACCCGGTT
TCCCACGCCCAATGGCACTCCTGG -> CCCACGCCCAATGGCACTCCTGGT
GGCAGTCGCAACACCGCAACGAAA -> GCAGTCGCAACACCGCAACGAAAC
TTCCAATCCTCAACATCAACGAAG -> TCCAATCCTCAACATCAACGAAGT
TCGCTCCGAACGTCCATCAACCCT -> CGCTCCGAACGTCCATCAACCCTC
GCCCGCTATCAGGTGACTCCTCAT -> CCCGCTATCAGGTGACTCCTCATT
GCCTGTTGAATGCTTCAGTTAGAC -> CCTGTTGAATGCTTCAGTTAGACC
GTTCCGCAGTCTCGCTGGACCCTT -> TTCCGCAGTCTCGCTGGACCCTTG
TACCCCGCAGGTCGGCGGATTTGA -> ACCCCGCAGGTCGGCGGATTTGAC
TCTTTACCTCTACATTCGTCTTGC -> CTTTACCTCTACATTCGTCTTGCC
CCTAGCATGAGGCCGCGTGGCTGC -> CTAGCATGAGGCCGCGTGGCTGCA
ACTGTGTCACTGAACTCGCTGATT -> CTGTGTCACTGAACTCGCTGATTG
GCTCTTAGGCTGGCTAGATGTACT -> CTCTTAGGCTGGCTAGATGTACTT
CCTCGCGCAGGTAGCATGATGTGA -> CTCGCGCAGGTAGCATGATGTGAC
TCCATCAACCCTCGATGTTTGTAC -> CCATCAACCCTCGATGTTTGTACG
TTATTACCCGGTTTTCCATCGAGA -> TATTACCCGGTTTTCCATCGAGAA
AGCCTAGTCACGGCAAAAGTTGAA -> GCCTAGTCACGGCAAAAGTTGAAA
AGTCATAGGGTTCTCTGCGCTATT -> GTCATAGGGTTCTCTGCGCTATTG
TATGAACAACATATAGATATTGAC -> ATGAACAACATATAGATATTGACT
ATCGAACTCTGAAGCTCCAAACGT -> TCGAACTCTGAAGCTCCAAACGTA
AAGTGGGCCACACCAATTCGTCCA -> AGTGGGCCACACCAATTCGTCCAC
ATCGTTAATTCGTGTATGACAGGC -> TCGTTAATTCGTGTATGACAGGCA
CTGCCGTCCAGACCATGGAGCATT -> TGCCGTCCAGACCATGGAGCATTT
GACTCAGATCTCGGATTACGGCAC -> ACTCAGATCTCGGATTACGGCACA
AACGGGGCGTTGTGATTAGGACGT -> ACGGGGCGTTGTGATTAGGACGTG
TCCTCAACATCAACGAAGTGGGCC -> CCTCAACATCAACGAAGTGGGCCA
CTTCAGTTAGACCGATCGGCTGTT -> TTCAGTTAGACCGATCGGCTGTTA
ATCGCTCCGAACGTCCATCAACCC -> TCGCTCCGAACGTCCATCAACCCT
AACCCTAGGTGCTGTAGTTCCGGC -> ACCCTAGGTGCTGTAGTTCCGGCC
CAACGAAGTGGGCCACACCAATTC -> AACGAAGTGGGCCACACCAATTCG
CCCGAGCCTAGTCACGGCAAAAGT -> CCGAGCCTAGTCACGGCAAAAGTT
CATTATAAAAGGTATCCGACGTAT -> ATTATAAAAGGTATCCGACGTATC
TGGTCGACCGAGATATCGCTTGTG -> GGTCGACCGAGATATCGCTTGTGA
GAAACGGGGCGTTGTGATTAGGAC -> AAACGGGGCGTTGTGATTAGGACG
CAGAAGAGTAGTCCCCTCCAAAGA -> AGAAGAGTAGTCCCCTCCAAAGAC
CTCGGATTACGGCACAGAAGAGTA -> TCGGATTACGGCACAGAAGAGTAG
TGTAATCATATTCCAACCTTTTTC -> GTAATCATATTCCAACCTTTTTCC
TGGCTAGATGTACTTCGCGCATGG -> GGCTAGATGTACTTCGCGCATGGC
TTAATTCGGTGCCTGCCTTAGCGC -> TAATTCGGTGCCTGCCTTAGCGCA
AATCATATTCCAACCTTTTTCCAA -> ATCATATTCCAACCTTTTTCCAAT
CTATATCGTTAATTCGTGTATGAC -> TATATCGTTAATTCGTGTATGACA
TACGAAGAGAGTTCCATTGTCGCT -> ACGAAGAGAGTTCCATTGTCGCTC
CTTACGAGAAACTATTAGGCTACG -> TTACGAGAAACTATTAGGCTACGG
AGGGACGTATGAATTGGCCATGTC -> GGGACGTATGAATTGGCCATGTCC
CTGATTGGTCGACCGAGATATCGC -> TGATTGGTCGACCGAGATATCGCT
CTTTTAGTCATAGGGTTCTCTGCG -> TTTTAGTCATAGGGTTCTCTGCGC
GTCGGTCGCGTACTGACTCCTTCC -> TCGGTCGCGTACTGACTCCTTCCT
GAAAGTCTTACGAGAAACTATTAG -> AAAGTCTTACGAGAAACTATTAGG
ACATCAACGAAGTGGGCCACACCA -> CATCAACGAAGTGGGCCACACCAA
GGACGCTGATTTCGCTTGAGTTGA -> GACGCTGATTTCGCTTGAGTTGAC
GATTCCAGAACCAATTTGCACTCC -> ATTCCAGAACCAATTTGCACTCCT
GAATGCTTCAGTTAGACCGATCGG -> AATGCTTCAGTTAGACCGATCGGC
ATGTCCGATTTGTCACTTCGAGAA -> TGTCCGATTTGTCACTTCGAGAAT
GTACGGGTTATTACCCGGTTTTCC -> TACGGGTTATTACCCGGTTTTCCA
GGGCAGTGGAGGCCTATAACAACC -> GGCAGTGGAGGCCTATAACAACCA
TCGGAAGTCTCTGGGGGTATTTAT -> CGGAAGTCTCTGGGGGTATTTATC
GCATGAGGCCGCGTGGCTGCAGTT -> CATGAGGCCGCGTGGCTGCAGTTT
CTGCGCTATTGCGCAATGCTGTGC -> TGCGCTATTGCGCAATGCTGTGCC
GTCAGGACTATGCTCTTAGGCTGG -> TCAGGACTATGCTCTTAGGCTGGC
CGGTCGCGTACTGACTCCTTCCTC -> GGTCGCGTACTGACTCCTTCCTCG
TATAAAAGGTATCCGACGTATCCC -> ATAAAAGGTATCCGACGTATCCCA
ACGTCACGAGAATGATCATCCAAT -> CGTCACGAGAATGATCATCCAATC
TGTATCGACGCGTAAATACCCGGT -> GTATCGACGCGTAAATACCCGGTA
GTAATCTTTACCTCTACATTCGTC -> TAATCTTTACCTCTACATTCGTCT
TTTGTCACTTCGAGAATGGCTCCG -> TTGTCACTTCGAGAATGGCTCCGG
CAGGTCGGCGGATTTGACAGCCAC -> AGGTCGGCGGATTTGACAGCCACC
GTCCATCAACCCTCGATGTTTGTA -> TCCATCAACCCTCGATGTTTGTAC
GGGACCGAAACGGGGCGTTGTGAT -> GGACCGAAACGGGGCGTTGTGATT
TCTCAACTATCCACTGTGTCACTG -> CTCAACTATCCACTGTGTCACTGA
CATATAGATATTGACTATTGTCCC -> ATATAGATATTGACTATTGTCCCC
AAGGTGATCTGCGGGGGTTCTGAT -> AGGTGATCTGCGGGGGTTCTGATA
CGCGTACTGACTCCTTCCTCGCGC -> GCGTACTGACTCCTTCCTCGCGCA
TGTGCATCGCCCAAGGGACGTATG -> GTGCATCGCCCAAGGGACGTATGA
CAATGGCACTCCTGGTCTCACAGG -> AATGGCACTCCTGGTCTCACAGGC
ACGAGAATGATCATCCAATCATAA -> CGAGAATGATCATCCAATCATAAT
GGAGCATTTGCGTTACACGTACCG -> GAGCATTTGCGTTACACGTACCGA
GGCATGTCACTGTAGTTGGGGTGA -> GCATGTCACTGTAGTTGGGGTGAC
TGGGGTGACATATCAGTGTTTATC -> GGGGTGACATATCAGTGTTTATCT
GCTGATTGGTCGACCGAGATATCG -> CTGATTGGTCGACCGAGATATCGC
CATAATGGAGGACATTGTGCTACA -> ATAATGGAGGACATTGTGCTACAT
AGGTCAGGACTATGCTCTTAGGCT -> GGTCAGGACTATGCTCTTAGGCTG
CGGCGGATTTGACAGCCACCTAGG -> GGCGGATTTGACAGCCACCTAGGT
GTCACACAAATGCTATAGAACCCG -> TCACACAAATGCTATAGAACCCGG
AGAACCAATTTGCACTCCTAGCCG -> GAACCAATTTGCACTCCTAGCCGA
GCAGATCTCACATGCCTTGTCTTG -> CAGATCTCACATGCCTTGTCTTGG
ATTACGGCACAGAAGAGTAGTCCC -> TTACGGCACAGAAGAGTAGTCCCC
AGACCATCGAACTCTGAAGCTCCA -> GACCATCGAACTCTGAAGCTCCAA
CTTTTTCCAATCCTCAACATCAAC -> TTTTTCCAATCCTCAACATCAACG
TTGGTCAATGTTCGCGGTCCATCG -> TGGTCAATGTTCGCGGTCCATCGC
TTACACGTACCGACCGGTGCTACA -> TACACGTACCGACCGGTGCTACAT
CTTGATGGCATGTCACTGTAGTTG -> TTGATGGCATGTCACTGTAGTTGG
TTCGCGCATGGCGTTCATATCCGT -> TCGCGCATGGCGTTCATATCCGTT
ATAGCCGTAACTAGCGCATTGGAC -> TAGCCGTAACTAGCGCATTGGACG
TGGCTCCGGTTTCAGCCACTGAAC -> GGCTCCGGTTTCAGCCACTGAACA
TCCATCGCTCCGAACGTCCATCAA -> CCATCGCTCCGAACGTCCATCAAC
CCGGCCGAGGTCGGTGGTAAAAGG -> CGGCCGAGGTCGGTGGTAAAAGGA
TACTTCGCGCATGGCGTTCATATC -> ACTTCGCGCATGGCGTTCATATCC
CGCGCATGGCGTTCATATCCGTTC -> GCGCATGGCGTTCATATCCGTTCC
GTGATCTGCGGGGGTTCTGATATG -> TGATCTGCGGGGGTTCTGATATGA
TATTTATCATGGGGTTAGATCGAC -> ATTTATCATGGGGTTAGATCGACT
CCATAGCCGTAACTAGCGCATTGG -> CATAGCCGTAACTAGCGCATTGGA
CCTGTTGAATGCTTCAGTTAGACC -> CTGTTGAATGCTTCAGTTAGACCG
CCTTGTCTTGGCGAGCACTTGAAG -> CTTGTCTTGGCGAGCACTTGAAGT
ACAGCCACCTAGGTCAGGACTATG -> CAGCCACCTAGGTCAGGACTATGC
TTGGCCATGTCCGTATTTTCACTC -> TGGCCATGTCCGTATTTTCACTCG
GTTAGACCGATCGGCTGTTAGCTC -> TTAGACCGATCGGCTGTTAGCTCA
CAGAGGACTCAGATCTCGGATTAC -> AGAGGACTCAGATCTCGGATTACG
CCTAGGTGCTGTAGTTCCGGCCGA -> CTAGGTGCTGTAGTTCCGGCCGAG
AATACCGCCGATTGTTTACATACT -> ATACCGCCGATTGTTTACATACTG
ACTCGCTGATTGGTCGACCGAGAT -> CTCGCTGATTGGTCGACCGAGATA
AATGGCACTCCTGGTCTCACAGGC -> ATGGCACTCCTGGTCTCACAGGCG
ACTGAACAGAGGACTCAGATCTCG -> CTGAACAGAGGACTCAGATCTCGG
CAGGCAGTTCCTAGCATGAGGCCG -> AGGCAGTTCCTAGCATGAGGCCGC
GCTTGATGGCATGTCACTGTAGTT -> CTTGATGGCATGTCACTGTAGTTG
ATCATCCAATCATAATGGAGGACA -> TCATCCAATCATAATGGAGGACAT
CGCTGATTTCGCTTGAGTTGACAT -> GCTGATTTCGCTTGAGTTGACATC
AAAGTACCGGTAAACATACTTAGT -> AAGTACCGGTAAACATACTTAGTC
TATTCCAACCTTTTTCCAATCCTC -> ATTCCAACCTTTTTCCAATCCTCA
TTTTCCAATCCTCAACATCAACGA -> TTTCCAATCCTCAACATCAACGAA
CACAAGCTGGGGTGTGCATCGCCC -> ACAAGCTGGGGTGTGCATCGCCCA
GGAACGTCACGAGAATGATCATCC -> GAACGTCACGAGAATGATCATCCA
TATGTCCGATTTGTCACTTCGAGA -> ATGTCCGATTTGTCACTTCGAGAA
GCTGTTAGCTCAACCTGCGCAGGA -> CTGTTAGCTCAACCTGCGCAGGAC
TCGTCGGTCGCGTACTGACTCCTT -> CGTCGGTCGCGTACTGACTCCTTC
TCTTTCGATATACGGCAGTCGCAA -> CTTTCGATATACGGCAGTCGCAAC
CTGAAGACAAGTCTGGGTATGGGG -> TGAAGACAAGTCTGGGTATGGGGG
TGAAGACAAGTCTGGGTATGGGGG -> GAAGACAAGTCTGGGTATGGGGGG
ATAATGGAGGACATTGTGCTACAT -> TAATGGAGGACATTGTGCTACATC
AGAAATCATACGGTTCTATCCAGT -> GAAATCATACGGTTCTATCCAGTA
CGTGGTACCCTCCTCGGAACGTCA -> GTGGTACCCTCCTCGGAACGTCAC
TATTGACTATTGTCCCCAAAAATG -> ATTGACTATTGTCCCCAAAAATGT
AATCATACGGTTCTATCCAGTATG -> ATCATACGGTTCTATCCAGTATGT
CTACATATCGACACCTGGCAGTAT -> TACATATCGACACCTGGCAGTATT
AGTCACACAAATGCTATAGAACCC -> GTCACACAAATGCTATAGAACCCG
ATTTCGGATCACAGGTGCTACTGC -> TTTCGGATCACAGGTGCTACTGCC
CCGTAACTAGCGCATTGGACGCTG -> CGTAACTAGCGCATTGGACGCTGA
GCATCGCCCAAGGGACGTATGAAT -> CATCGCCCAAGGGACGTATGAATT
GATCTATATCGTTAATTCGTGTAT -> ATCTATATCGTTAATTCGTGTATG
CCATCGAGAAATCATACGGTTCTA -> CATCGAGAAATCATACGGTTCTAT
AAAGTTGAAACACAGACTGCAAGA -> AAGTTGAAACACAGACTGCAAGAA
ACATCCGGGATGCGTGTGCCGTCC -> CATCCGGGATGCGTGTGCCGTCCC
GTATGACAGGCAGTTCCTAGCATG -> TATGACAGGCAGTTCCTAGCATGA
TCATTTCGGATCACAGGTGCTACT -> CATTTCGGATCACAGGTGCTACTG
TGATACTGTCTATGAGTAATCTTT -> GATACTGTCTATGAGTAATCTTTA
GCCACACCAATTCGTCCACAAGCT -> CCACACCAATTCGTCCACAAGCTG
TCATACGGTTCTATCCAGTATGTC -> CATACGGTTCTATCCAGTATGTCC
TTGTGCTACATCATTTCGGATCAC -> TGTGCTACATCATTTCGGATCACA
TAATCTTTACCTCTACATTCGTCT -> AATCTTTACCTCTACATTCGTCTT
GTGTTTATCTCGTCGTCGGTCGCG -> TGTTTATCTCGTCGTCGGTCGCGT
GACCCCGTGTCGTACCTGAAAACT -> ACCCCGTGTCGTACCTGAAAACTA
TATCTTTCGTAAGAGCATACCCCT -> ATCTTTCGTAAGAGCATACCCCTC
CGTCCACAAGCTGGGGTGTGCATC -> GTCCACAAGCTGGGGTGTGCATCG
CAACTCCGGGGTTTAGATCTATAT -> AACTCCGGGGTTTAGATCTATATC
ACTATAGGTCAACCCTAGGTGCTG -> CTATAGGTCAACCCTAGGTGCTGT
TTTGGTCATGGTTCTATTTTAGTT -> TTGGTCATGGTTCTATTTTAGTTC
TTCGTAAGAGCATACCCCTCGCAT -> TCGTAAGAGCATACCCCTCGCATG
CCACTGTGTCACTGAACTCGCTGA -> CACTGTGTCACTGAACTCGCTGAT
CTTAGGCTGGCTAGATGTACTTCG -> TTAGGCTGGCTAGATGTACTTCGC
TCGGCGGATTTGACAGCCACCTAG -> CGGCGGATTTGACAGCCACCTAGG
CAGATCTCGGATTACGGCACAGAA -> AGATCTCGGATTACGGCACAGAAG
TTCAGTTAGACCGATCGGCTGTTA -> TCAGTTAGACCGATCGGCTGTTAG
ACATACTTAGTCAGGGGCAAGTCA -> CATACTTAGTCAGGGGCAAGTCAC
GCGCAATGCTGTGCCGTTCGGAAG -> CGCAATGCTGTGCCGTTCGGAAGT
TCCCCGTATCTTTCGTAAGAGCAT -> CCCCGTATCTTTCGTAAGAGCATA
CTTGAGTTGACATCCGGGATGCGT -> TTGAGTTGACATCCGGGATGCGTG
CATAGGGTTCTCTGCGCTATTGCG -> ATAGGGTTCTCTGCGCTATTGCGC
GGCGTTGTGATTAGGACGTGGTAC -> GCGTTGTGATTAGGACGTGGTACC
TCGGATCACAGGTGCTACTGCCGT -> CGGATCACAGGTGCTACTGCCGTC
TCGACGCGTAAATACCCGGTACAC -> CGACGCGTAAATACCCGGTACACC
GCCTGCCTTAGCGCAGATCTCACA -> CCTGCCTTAGCGCAGATCTCACAT
TGTGCTACATCATTTCGGATCACA -> GTGCTACATCATTTCGGATCACAG
TTCCGACTTCTCAACTATCCACTG -> TCCGACTTCTCAACTATCCACTGT
CTGATTTCGCTTGAGTTGACATCC -> TGATTTCGCTTGAGTTGACATCCG
GTTACACGTACCGACCGGTGCTAC -> TTACACGTACCGACCGGTGCTACA
CATGCCTTGTCTTGGCGAGCACTT -> ATGCCTTGTCTTGGCGAGCACTTG
CAAAAATGTTGGACACTGCCCGGA -> AAAAATGTTGGACACTGCCCGGAT
CTTTACCCCGCAGGTCGGCGGATT -> TTTACCCCGCAGGTCGGCGGATTT
ACCAATTCGTCCACAAGCTGGGGT -> CCAATTCGTCCACAAGCTGGGGTG
GATTTGTCACTTCGAGAATGGCTC -> ATTTGTCACTTCGAGAATGGCTCC
AGTAATCTTTACCTCTACATTCGT -> GTAATCTTTACCTCTACATTCGTC
ACAGACTGCAAGAAAGTCTTACGA -> CAGACTGCAAGAAAGTCTTACGAG
TATACGGCAGTCGCAACACCGCAA -> ATACGGCAGTCGCAACACCGCAAC
TTTCGATATACGGCAGTCGCAACA -> TTCGATATACGGCAGTCGCAACAC
ATGTTCGCGGTCCATCGCTCCGAA -> TGTTCGCGGTCCATCGCTCCGAAC
TCGATATACGGCAGTCGCAACACC -> CGATATACGGCAGTCGCAACACCG
TTTCAGCCACTGAACAGAGGACTC -> TTCAGCCACTGAACAGAGGACTCA
ATACGGCAGTCGCAACACCGCAAC -> TACGGCAGTCGCAACACCGCAACG
TAGATCTATATCGTTAATTCGTGT -> AGATCTATATCGTTAATTCGTGTA
CGAACGTCCATCAACCCTCGATGT -> GAACGTCCATCAACCCTCGATGTT
AGGCCTGTTGAATGCTTCAGTTAG -> GGCCTGTTGAATGCTTCAGTTAGA
CCTGGCAGTATTGAGGCTATGAAC -> CTGGCAGTATTGAGGCTATGAACA
TGACCCCGTGTCGTACCTGAAAAC -> GACCCCGTGTCGTACCTGAAAACT
CGGGACCGAAACGGGGCGTTGTGA -> GGGACCGAAACGGGGCGTTGTGAT
AACTACTGAGAACCGGGGCAGTGG -> ACTACTGAGAACCGGGGCAGTGGA
CCGTATTTTCACTCGATTAATTCG -> CGTATTTTCACTCGATTAATTCGG
TCGCCCAAGGGACGTATGAATTGG -> CGCCCAAGGGACGTATGAATTGGC
GATGTACTTCGCGCATGGCGTTCA -> ATGTACTTCGCGCATGGCGTTCAT
GAAGTCCGATGAGAAAAAGTACCG -> AAGTCCGATGAGAAAAAGTACCGG
GCCTAGTCACGGCAAAAGTTGAAA -> CCTAGTCACGGCAAAAGTTGAAAC
GTATGAATTGGCCATGTCCGTATT -> TATGAATTGGCCATGTCCGTATTT
GCTGTGCCGTTCGGAAGTCTCTGG -> CTGTGCCGTTCGGAAGTCTCTGGG
GGGTTCTGATATGATTTGGTCATG -> GGTTCTGATATGATTTGGTCATGG
GTTGACATCCGGGATGCGTGTGCC -> TTGACATCCGGGATGCGTGTGCCG
CGTAAGAGCATACCCCTCGCATGT -> GTAAGAGCATACCCCTCGCATGTA
GGGGGGAAAATTGGTCAATGTTCG -> GGGGGAAAATTGGTCAATGTTCGC
CTATCCAGTATGTCCGATTTGTCA -> TATCCAGTATGTCCGATTTGTCAC
CACAAATGCTATAGAACCCGGCGC -> ACAAATGCTATAGAACCCGGCGCG
TAGATGTACTTCGCGCATGGCGTT -> AGATGTACTTCGCGCATGGCGTTC
ACTCGATTAATTCGGTGCCTGCCT -> CTCGATTAATTCGGTGCCTGCCTT
TCTGCGGGGGTTCTGATATGATTT -> CTGCGGGGGTTCTGATATGATTTG
TGTGTCACTGAACTCGCTGATTGG -> GTGTCACTGAACTCGCTGATTGGT
CACGCCCAATGGCACTCCTGGTCT -> ACGCCCAATGGCACTCCTGGTCTC
GGTCGGCGGATTTGACAGCCACCT -> GTCGGCGGATTTGACAGCCACCTA
GCCTTAGCGCAGATCTCACATGCC -> CCTTAGCGCAGATCTCACATGCCT
ATCGAGAAATCATACGGTTCTATC -> TCGAGAAATCATACGGTTCTATCC
CGCATGGCGTTCATATCCGTTCCG -> GCATGGCGTTCATATCCGTTCCGA
TAGTTCCGCAGTCTCGCTGGACCC -> AGTTCCGCAGTCTCGCTGGACCCT
CGCAGATCTCACATGCCTTGTCTT -> GCAGATCTCACATGCCTTGTCTTG
ATATCCGTTCCGACTTCTCAACTA -> TATCCGTTCCGACTTCTCAACTAT
GTTCTATTTTAGTTCCGCAGTCTC -> TTCTATTTTAGTTCCGCAGTCTCG
CTGACTCCTTCCTCGCGCAGGTAG -> TGACTCCTTCCTCGCGCAGGTAGC
TCGTCTTGCCCCGAGCCTAGTCAC -> CGTCTTGCCCCGAGCCTAGTCACG
GTATGTCCGATTTGTCACTTCGAG -> TATGTCCGATTTGTCACTTCGAGA
TAGCGCATTGGACGCTGATTTCGC -> AGCGCATTGGACGCTGATTTCGCT
CTAATATCCGGTGTAATCATATTC -> TAATATCCGGTGTAATCATATTCC
ATGGGGGGAAAATTGGTCAATGTT -> TGGGGGGAAAATTGGTCAATGTTC
GATATGATTTGGTCATGGTTCTAT -> ATATGATTTGGTCATGGTTCTATT
CCAATCATAATGGAGGACATTGTG -> CAATCATAATGGAGGACATTGTGC
TTCCATTGTCGCTCGTAAGGTGAT -> TCCATTGTCGCTCGTAAGGTGATC
CTACGGCTTGATGGCATGTCACTG -> TACGGCTTGATGGCATGTCACTGT
AGATCTCACATGCCTTGTCTTGGC -> GATCTCACATGCCTTGTCTTGGCG
TCTCACAGGCGCTACTTTTAGTCA -> CTCACAGGCGCTACTTTTAGTCAT
GTGATTAGGACGTGGTACCCTCCT -> TGATTAGGACGTGGTACCCTCCTC
CGCGGTCCATCGCTCCGAACGTCC -> GCGGTCCATCGCTCCGAACGTCCA
GCGCGTCTGCATACGGCTAGCATG -> CGCGTCTGCATACGGCTAGCATGG
GGGTTATTACCCGGTTTTCCATCG -> GGTTATTACCCGGTTTTCCATCGA
GCATGGCCGATCTTTCGATATACG -> CATGGCCGATCTTTCGATATACGG
AGTCAGGGGCAAGTCACACAAATG -> GTCAGGGGCAAGTCACACAAATGC
CTGTCTATGAGTAATCTTTACCTC -> TGTCTATGAGTAATCTTTACCTCT
CGGATTTGACAGCCACCTAGGTCA -> GGATTTGACAGCCACCTAGGTCAG
GGGACGTATGAATTGGCCATGTCC -> GGACGTATGAATTGGCCATGTCCG
CCTATAACAACCAATTTAGCCCGC -> CTATAACAACCAATTTAGCCCGCT
CTACTGCCGTCCAGACCATGGAGC -> TACTGCCGTCCAGACCATGGAGCA
TATGCCCAACTCCGGGGTTTAGAT -> ATGCCCAACTCCGGGGTTTAGATC
GTATTTATCATGGGGTTAGATCGA -> TATTTATCATGGGGTTAGATCGAC
TTTCACTCGATTAATTCGGTGCCT -> TTCACTCGATTAATTCGGTGCCTG
CCATCGAACTCTGAAGCTCCAAAC -> CATCGAACTCTGAAGCTCCAAACG
TGGACGCTGATTTCGCTTGAGTTG -> GGACGCTGATTTCGCTTGAGTTGA
GAAGTACATGATTCCAGAACCAAT -> AAGTACATGATTCCAGAACCAATT
AGGCGCTACTTTTAGTCATAGGGT -> GGCGCTACTTTTAGTCATAGGGTT
ATGGTTCTATTTTAGTTCCGCAGT -> TGGTTCTATTTTAGTTCCGCAGTC
CACAGAAGAGTAGTCCCCTCCAAA -> ACAGAAGAGTAGTCCCCTCCAAAG
ACACCGCAACGAAACACAATACCG -> CACCGCAACGAAACACAATACCGC
GGGGAAAATTGGTCAATGTTCGCG -> GGGAAAATTGGTCAATGTTCGCGG
AATTCGGTGCCTGCCTTAGCGCAG -> ATTCGGTGCCTGCCTTAGCGCAGA
TCGCTTGAGTTGACATCCGGGATG -> CGCTTGAGTTGACATCCGGGATGC
AGGCTGGCTAGATGTACTTCGCGC -> GGCTGGCTAGATGTACTTCGCGCA
ACTCTGAAGCTCCAAACGTACTTT -> CTCTGAAGCTCCAAACGTACTTTA
GCTCCGGTTTCAGCCACTGAACAG -> CTCCGGTTTCAGCCACTGAACAGA
TCACAGGCGCTACTTTTAGTCATA -> CACAGGCGCTACTTTTAGTCATAG
AATTTAGCCCGCTATCAGGTGACT -> ATTTAGCCCGCTATCAGGTGACTC
CGTAAATACCCGGTACACCCTTCC -> GTAAATACCCGGTACACCCTTCCT
CCGACTTCTCAACTATCCACTGTG -> CGACTTCTCAACTATCCACTGTGT
GCAGTGGAGGCCTATAACAACCAA -> CAGTGGAGGCCTATAACAACCAAT
CTCGCATGTATCGACGCGTAAATA -> TCGCATGTATCGACGCGTAAATAC
AAGGTATCCGACGTATCCCAAAAG -> AGGTATCCGACGTATCCCAAAAGA
CGATGTTTGTACGGGTTATTACCC -> GATGTTTGTACGGGTTATTACCCG
ACACCCTTCCTCTTGGGTCGTCTG -> CACCCTTCCTCTTGGGTCGTCTGA
CTATTGCGCAATGCTGTGCCGTTC -> TATTGCGCAATGCTGTGCCGTTCG
GGGCCACACCAATTCGTCCACAAG -> GGCCACACCAATTCGTCCACAAGC
ACGCTGATTTCGCTTGAGTTGACA -> CGCTGATTTCGCTTGAGTTGACAT
ATTTCGCTTGAGTTGACATCCGGG -> TTTCGCTTGAGTTGACATCCGGGA
GGCCTATAACAACCAATTTAGCCC -> GCCTATAACAACCAATTTAGCCCG
GTGACATATCAGTGTTTATCTCGT -> TGACATATCAGTGTTTATCTCGTC
ATCGGCTGTTAGCTCAACCTGCGC -> TCGGCTGTTAGCTCAACCTGCGCA
ACTATGCTCTTAGGCTGGCTAGAT -> CTATGCTCTTAGGCTGGCTAGATG
GGCACTCCTGGTCTCACAGGCGCT -> GCACTCCTGGTCTCACAGGCGCTA
AAGTCCGATGAGAAAAAGTACCGG -> AGTCCGATGAGAAAAAGTACCGGT
TCGAACTCTGAAGCTCCAAACGTA -> CGAACTCTGAAGCTCCAAACGTAC
AGATATCGCTTGTGATACTGTCTA -> GATATCGCTTGTGATACTGTCTAT
ATGCCTTGTCTTGGCGAGCACTTG -> TGCCTTGTCTTGGCGAGCACTTGA
CTGTAGTTGGGGTGACATATCAGT -> TGTAGTTGGGGTGACATATCAGTG
ATGCTGTGCCGTTCGGAAGTCTCT -> TGCTGTGCCGTTCGGAAGTCTCTG
TGAAGTACATGATTCCAGAACCAA -> GAAGTACATGATTCCAGAACCAAT
TCGAGAATGGCTCCGGTTTCAGCC -> CGAGAATGGCTCCGGTTTCAGCCA
TGATTGGTCGACCGAGATATCGCT -> GATTGGTCGACCGAGATATCGCTT
GGTCGTCTGAACTACTGAGAACCG -> GTCGTCTGAACTACTGAGAACCGG
CGAGAATGATCATCCAATCATAAT -> GAGAATGATCATCCAATCATAATG
CCAGACCATGGAGCATTTGCGTTA -> CAGACCATGGAGCATTTGCGTTAC
TTCCGGCCGAGGTCGGTGGTAAAA -> TCCGGCCGAGGTCGGTGGTAAAAG
GGTTAGATCGACTATAGGTCAACC -> GTTAGATCGACTATAGGTCAACCC
CGGCAAAAGTTGAAACACAGACTG -> GGCAAAAGTTGAAACACAGACTGC
AATACCCGGTACACCCTTCCTCTT -> ATACCCGGTACACCCTTCCTCTTG
CCGTGTCGTACCTGAAAACTAATA -> CGTGTCGTACCTGAAAACTAATAT
CTACATTCGTCTTGCCCCGAGCCT -> TACATTCGTCTTGCCCCGAGCCTA
CTATCAGGTGACTCCTCATTATAA -> TATCAGGTGACTCCTCATTATAAA
ATATCCGGTGTAATCATATTCCAA -> TATCCGGTGTAATCATATTCCAAC
AAACTAATATCCGGTGTAATCATA -> AACTAATATCCGGTGTAATCATAT
ATGGCTCCGGTTTCAGCCACTGAA -> TGGCTCCGGTTTCAGCCACTGAAC
GCGCTATTGCGCAATGCTGTGCCG -> CGCTATTGCGCAATGCTGTGCCGT
GCGTCTGCATACGGCTAGCATGGC -> CGTCTGCATACGGCTAGCATGGCC
GGAGGCCTATAACAACCAATTTAG -> GAGGCCTATAACAACCAATTTAGC
GCAGGTAGCATGATGTGACTTATG -> CAGGTAGCATGATGTGACTTATGC
GGATCACAGGTGCTACTGCCGTCC -> GATCACAGGTGCTACTGCCGTCCA
GATCGGCTGTTAGCTCAACCTGCG -> ATCGGCTGTTAGCTCAACCTGCGC
ATCCGGTGTAATCATATTCCAACC -> TCCGGTGTAATCATATTCCAACCT
TGTGCCGTCCCCGTATCTTTCGTA -> GTGCCGTCCCCGTATCTTTCGTAA
CTCAACATCAACGAAGTGGGCCAC -> TCAACATCAACGAAGTGGGCCACA
GGGTATGGGGGGAAAATTGGTCAA -> GGTATGGGGGGAAAATTGGTCAAT
GGCCGATCTTTCGATATACGGCAG -> GCCGATCTTTCGATATACGGCAGT
CTGGACCCTTGGCCATAGCCGTAA -> TGGACCCTTGGCCATAGCCGTAAC
GAGAACCGGGGCAGTGGAGGCCTA -> AGAACCGGGGCAGTGGAGGCCTAT
CTATGCTCTTAGGCTGGCTAGATG -> TATGCTCTTAGGCTGGCTAGATGT
ACGGCAAAAGTTGAAACACAGACT -> CGGCAAAAGTTGAAACACAGACTG
TAGTCATAGGGTTCTCTGCGCTAT -> AGTCATAGGGTTCTCTGCGCTATT
CACAGGCGCTACTTTTAGTCATAG -> ACAGGCGCTACTTTTAGTCATAGG
TTGTCGCTCGTAAGGTGATCTGCG -> TGTCGCTCGTAAGGTGATCTGCGG
AGGATCGGGACCGAAACGGGGCGT -> GGATCGGGACCGAAACGGGGCGTT
CTGAACTCGCTGATTGGTCGACCG -> TGAACTCGCTGATTGGTCGACCGA
TTAGCCCGCTATCAGGTGACTCCT -> TAGCCCGCTATCAGGTGACTCCTC
GAGCATTTGCGTTACACGTACCGA -> AGCATTTGCGTTACACGTACCGAC
TGATCTGCGGGGGTTCTGATATGA -> GATCTGCGGGGGTTCTGATATGAT
GCTACATATCGACACCTGGCAGTA -> CTACATATCGACACCTGGCAGTAT
CGTTCGGAAGTCTCTGGGGGTATT -> GTTCGGAAGTCTCTGGGGGTATTT
GGCGCTACTTTTAGTCATAGGGTT -> GCGCTACTTTTAGTCATAGGGTTC
CAACTATCCACTGTGTCACTGAAC -> AACTATCCACTGTGTCACTGAACT
TACCGACCGGTGCTACATATCGAC -> ACCGACCGGTGCTACATATCGACA
CCGGTTTTCCATCGAGAAATCATA -> CGGTTTTCCATCGAGAAATCATAC
GTCGGCGGATTTGACAGCCACCTA -> TCGGCGGATTTGACAGCCACCTAG
CATTTCGGATCACAGGTGCTACTG -> ATTTCGGATCACAGGTGCTACTGC
GACTATGCTCTTAGGCTGGCTAGA -> ACTATGCTCTTAGGCTGGCTAGAT
ACGGCTAGCATGGCCGATCTTTCG -> CGGCTAGCATGGCCGATCTTTCGA
ATGCTCTTAGGCTGGCTAGATGTA -> TGCTCTTAGGCTGGCTAGATGTAC
GTTCTGATATGATTTGGTCATGGT -> TTCTGATATGATTTGGTCATGGTT
ACTGCAAGAAAGTCTTACGAGAAA -> CTGCAAGAAAGTCTTACGAGAAAC
CGCAACACCGCAACGAAACACAAT -> GCAACACCGCAACGAAACACAATA
CTCACAGGCGCTACTTTTAGTCAT -> TCACAGGCGCTACTTTTAGTCATA
CATACTTAGTCAGGGGCAAGTCAC -> ATACTTAGTCAGGGGCAAGTCACA
